Rk,Player,Pos,Age,Tm,G,GS,MP,FG,FGA,FG%,3P,3PA,3P%,2P,2PA,2P%,eFG%,FT,FTA,FT%,ORB,DRB,TRB,AST,STL,BLK,TOV,PF,PTS
1,Precious Achiuwa\achiupr01,C-PF,24,TOT,36,0,579,99,207,0.478,14,52,0.269,85,155,0.548,0.512,27,46,0.587,70,112,182,47,19,19,38,57,239
1,Precious Achiuwa\achiupr01,C,24,TOR,25,0,437,78,170,0.459,13,47,0.277,65,123,0.528,0.497,24,42,0.571,50,86,136,44,16,12,29,40,193
1,Precious Achiuwa\achiupr01,PF,24,NYK,11,0,142,21,37,0.568,1,5,0.2,20,32,0.625,0.581,3,4,0.75,20,26,46,3,3,7,9,17,46
2,Bam Adebayo\adebaba01,C,26,MIA,33,33,1155,261,519,0.503,1,10,0.1,260,509,0.511,0.504,188,239,0.787,75,271,346,142,35,29,86,84,711
3,Ochai Agbaji\agbajoc01,SG,23,UTA,44,10,883,98,226,0.434,43,132,0.326,55,94,0.585,0.529,15,20,0.75,33,79,112,41,26,26,32,63,254
4,Santi Aldama\aldamsa01,PF,23,MEM,32,6,743,124,287,0.432,49,146,0.336,75,141,0.532,0.517,33,54,0.611,38,141,179,54,21,25,36,52,330
5,Nickeil Alexander-Walker\alexani01,SG,25,MIN,42,12,936,98,234,0.419,56,156,0.359,42,78,0.538,0.538,16,23,0.696,17,58,75,101,37,26,41,77,268
6,Grayson Allen\allengr01,SG,28,PHO,37,37,1233,172,339,0.507,103,212,0.486,69,127,0.543,0.659,63,70,0.9,29,125,154,109,34,24,53,79,510
7,Jarrett Allen\allenja01,C,25,CLE,35,35,1061,212,318,0.667,0,1,0.0,212,317,0.669,0.667,93,122,0.762,120,238,358,103,33,38,62,85,517
8,Jose Alvarado\alvarjo01,PG,25,NOP,26,0,428,63,155,0.406,33,87,0.379,30,68,0.441,0.513,20,31,0.645,12,44,56,48,25,10,20,38,179
9,Kyle Anderson\anderky01,PF,30,MIN,42,2,951,107,228,0.469,5,29,0.172,102,199,0.513,0.48,56,81,0.691,28,119,147,164,34,27,58,69,275
10,Giannis Antetokounmpo\antetgi01,PF,29,MIL,40,40,1409,462,759,0.609,16,69,0.232,446,690,0.646,0.619,307,459,0.669,108,347,455,241,53,44,147,116,1247
11,Thanasis Antetokounmpo\antetth01,PF,31,MIL,17,0,74,7,14,0.5,0,0,,7,14,0.5,0.5,0,0,,4,4,8,9,2,3,8,14,14
12,Cole Anthony\anthoco01,PG,23,ORL,42,0,1028,188,436,0.431,50,153,0.327,138,283,0.488,0.489,127,152,0.836,44,133,177,137,33,21,78,111,553
13,OG Anunoby\anunoog01,SF,26,TOT,38,38,1304,217,438,0.495,81,212,0.382,136,226,0.602,0.588,57,72,0.792,38,125,163,87,41,26,57,90,572
13,OG Anunoby\anunoog01,SF,26,TOR,27,27,900,157,321,0.489,61,163,0.374,96,158,0.608,0.584,33,46,0.717,24,82,106,72,28,13,43,62,408
13,OG Anunoby\anunoog01,SF,26,NYK,11,11,404,60,117,0.513,20,49,0.408,40,68,0.588,0.598,24,26,0.923,14,43,57,15,13,13,14,28,164
14,Ryan Arcidiacono\arcidry01,PG,29,NYK,16,0,36,0,5,0.0,0,5,0.0,0,0,,0.0,0,0,,0,7,7,4,1,0,0,4,0
15,Deni Avdija\avdijde01,SF,23,WAS,42,42,1146,192,386,0.497,39,112,0.348,153,274,0.558,0.548,90,119,0.756,43,216,259,163,38,16,73,104,513
16,Deandre Ayton\aytonde01,C,25,POR,26,26,813,152,283,0.537,0,0,,152,283,0.537,0.537,28,36,0.778,85,185,270,39,28,18,52,63,332
17,Udoka Azubuike\azubuud01,C,24,PHO,11,0,91,15,19,0.789,0,0,,15,19,0.789,0.789,3,9,0.333,9,16,25,3,0,6,4,16,33
18,Ibou Badji\badjiib01,C,21,POR,12,1,163,9,15,0.6,0,0,,9,15,0.6,0.6,3,6,0.5,18,26,44,8,2,17,9,32,21
19,Marvin Bagley III\baglema01,C-PF,24,TOT,29,12,570,130,225,0.578,2,9,0.222,128,216,0.593,0.582,58,74,0.784,64,84,148,32,8,17,34,51,320
19,Marvin Bagley III\baglema01,C,24,DET,26,10,478,107,181,0.591,1,6,0.167,106,175,0.606,0.594,50,61,0.82,46,72,118,27,5,14,29,40,265
19,Marvin Bagley III\baglema01,PF,24,WAS,3,2,92,23,44,0.523,1,3,0.333,22,41,0.537,0.534,8,13,0.615,18,12,30,5,3,3,5,11,55
20,Amari Bailey\baileam01,PG,19,CHO,2,0,11,2,6,0.333,0,2,0.0,2,4,0.5,0.333,1,2,0.5,2,0,2,0,0,0,1,0,5
21,Patrick Baldwin Jr.\baldwpa01,SF,21,WAS,13,0,102,13,30,0.433,8,16,0.5,5,14,0.357,0.567,7,10,0.7,5,23,28,6,1,3,5,17,41
22,LaMelo Ball\ballla01,PG,22,CHO,19,19,621,164,368,0.446,66,174,0.379,98,194,0.505,0.535,82,94,0.872,26,75,101,148,34,4,75,68,476
23,Mo Bamba\bambamo01,C,25,PHI,24,0,215,39,71,0.549,10,18,0.556,29,53,0.547,0.62,14,21,0.667,33,40,73,13,10,19,15,29,102
24,Paolo Banchero\banchpa01,PF,21,ORL,43,43,1501,347,770,0.451,61,171,0.357,286,599,0.477,0.49,218,311,0.701,52,255,307,207,44,26,137,90,973
25,Desmond Bane\banede01,SG,25,MEM,37,37,1277,330,696,0.474,123,320,0.384,207,376,0.551,0.563,121,140,0.864,34,135,169,196,38,20,99,106,904
26,Dalano Banton\bantoda01,PG,24,BOS,20,1,144,18,42,0.429,2,12,0.167,16,30,0.533,0.452,14,18,0.778,12,21,33,11,4,3,9,19,52
27,Dominick Barlow\barlodo01,PF,20,SAS,19,1,244,31,68,0.456,3,7,0.429,28,61,0.459,0.478,13,22,0.591,22,42,64,20,8,10,4,25,78
28,Harrison Barnes\barneha02,PF,31,SAC,41,41,1192,147,310,0.474,69,175,0.394,78,135,0.578,0.585,70,87,0.805,34,80,114,52,27,6,30,52,433
29,Scottie Barnes\barnesc01,SG,22,TOR,43,43,1506,327,680,0.481,87,237,0.367,240,443,0.542,0.545,125,169,0.74,97,262,359,244,59,63,113,89,866
30,RJ Barrett\barrerj01,SG,23,TOT,37,37,1130,248,542,0.458,61,176,0.347,187,366,0.511,0.514,139,180,0.772,30,158,188,103,19,13,65,79,696
30,RJ Barrett\barrerj01,SG,23,NYK,26,26,766,164,388,0.423,43,130,0.331,121,258,0.469,0.478,103,124,0.831,19,92,111,63,12,9,47,45,474
30,RJ Barrett\barrerj01,SG,23,TOR,11,11,364,84,154,0.545,18,46,0.391,66,108,0.611,0.604,36,56,0.643,11,66,77,40,7,4,18,34,222
31,Charles Bassey\bassech01,C,23,SAS,19,0,205,29,40,0.725,0,1,0.0,29,39,0.744,0.725,5,6,0.833,23,53,76,21,8,17,15,31,63
32,Emoni Bates\batesem01,SF,20,CLE,10,0,76,6,25,0.24,5,20,0.25,1,5,0.2,0.34,1,2,0.5,1,9,10,6,1,2,1,5,18
33,Keita Bates-Diop\bateske01,SF,28,PHO,31,8,494,48,124,0.387,14,53,0.264,34,71,0.479,0.444,25,34,0.735,24,60,84,28,19,15,7,31,135
34,Nicolas Batum\batumni01,PF,35,TOT,30,23,742,63,120,0.525,40,87,0.46,23,33,0.697,0.692,9,14,0.643,35,77,112,68,20,25,18,59,175
34,Nicolas Batum\batumni01,PF,35,LAC,3,0,54,3,8,0.375,2,7,0.286,1,1,1.0,0.5,0,0,,0,7,7,5,3,4,1,5,8
34,Nicolas Batum\batumni01,PF,35,PHI,27,23,688,60,112,0.536,38,80,0.475,22,32,0.688,0.705,9,14,0.643,35,70,105,63,17,21,17,54,167
35,Bradley Beal\bealbr01,SG,30,PHO,18,18,576,128,247,0.518,26,68,0.382,102,179,0.57,0.571,42,55,0.764,14,60,74,71,15,6,39,49,324
36,Malik Beasley\beaslma01,SG,27,MIL,40,40,1174,169,344,0.491,116,246,0.472,53,98,0.541,0.66,12,16,0.75,26,135,161,54,29,5,27,83,466
37,MarJon Beauchamp\beaucma01,SF,23,MIL,34,1,534,64,135,0.474,25,62,0.403,39,73,0.534,0.567,12,20,0.6,20,64,84,29,11,6,24,47,165
38,Jules Bernard\bernaju01,SG,24,WAS,3,0,15,1,8,0.125,0,6,0.0,1,2,0.5,0.125,0,0,,1,0,1,1,0,0,1,3,2
39,Dāvis Bertāns\bertada01,PF,31,OKC,12,0,83,9,24,0.375,9,22,0.409,0,2,0.0,0.563,14,15,0.933,2,8,10,8,2,2,1,10,41
40,Patrick Beverley\beverpa01,PG,35,PHI,39,1,723,74,175,0.423,27,86,0.314,47,89,0.528,0.5,35,46,0.761,26,93,119,100,21,13,32,66,210
41,Saddiq Bey\beysa01,SF,24,ATL,42,30,1364,181,440,0.411,73,234,0.312,108,206,0.524,0.494,93,113,0.823,104,165,269,55,41,6,41,68,528
42,Goga Bitadze\bitadgo01,C,24,ORL,38,31,799,109,178,0.612,2,10,0.2,107,168,0.637,0.618,46,68,0.676,95,153,248,65,27,61,31,91,266
43,Onuralp Bitim\bitimon01,SG,24,CHI,1,0,3,0,0,,0,0,,0,0,,,0,0,,0,0,0,0,0,0,0,0,0
44,Bismack Biyombo\biyombi01,C,31,MEM,30,27,718,67,119,0.563,0,0,,67,119,0.563,0.563,22,46,0.478,57,134,191,51,10,34,38,82,156
45,Anthony Black\blackan01,PG,20,ORL,40,28,769,76,155,0.49,20,56,0.357,56,99,0.566,0.555,31,49,0.633,21,75,96,69,25,15,39,80,203
46,Leaky Black\blackle01,SF,24,CHO,11,0,59,6,10,0.6,1,3,0.333,5,7,0.714,0.65,0,2,0.0,2,5,7,4,3,3,2,3,13
47,Bogdan Bogdanović\bogdabo01,SG,31,ATL,40,3,1123,239,563,0.425,123,337,0.365,116,226,0.513,0.534,69,77,0.896,21,107,128,104,55,9,44,94,670
48,Bojan Bogdanović\bogdabo02,PF,34,DET,21,20,706,148,319,0.464,63,154,0.409,85,165,0.515,0.563,56,75,0.747,13,64,77,56,21,2,48,48,415
49,Bol Bol\bolbo01,PF,24,PHO,12,0,86,17,23,0.739,3,5,0.6,14,18,0.778,0.804,4,5,0.8,9,18,27,6,3,6,6,10,41
50,Marques Bolden\boldema01,C,25,MIL,2,0,3,0,0,,0,0,,0,0,,,0,0,,0,2,2,0,0,0,0,1,0
51,Devin Booker\bookede01,PG,27,PHO,33,33,1187,308,636,0.484,69,186,0.371,239,450,0.531,0.539,206,232,0.888,24,136,160,255,28,11,92,103,891
52,Brandon Boston Jr.\bostobr01,SF,22,LAC,8,0,59,13,32,0.406,4,14,0.286,9,18,0.5,0.469,6,6,1.0,3,5,8,4,1,0,3,10,36
53,Chris Boucher\bouchch01,PF,31,TOR,40,0,569,84,178,0.472,26,79,0.329,58,99,0.586,0.545,52,70,0.743,47,114,161,17,13,19,19,56,246
54,James Bouknight\bouknja01,SG,23,CHO,10,0,64,14,30,0.467,11,22,0.5,3,8,0.375,0.65,1,2,0.5,1,8,9,6,0,1,1,2,40
55,Jamaree Bouyea\bouyeja01,PG,24,POR,6,0,57,5,21,0.238,0,8,0.0,5,13,0.385,0.238,0,0,,2,8,10,8,0,0,8,3,10
56,Malaki Branham\branhma01,PG,20,SAS,41,21,853,140,325,0.431,39,128,0.305,101,197,0.513,0.491,21,23,0.913,12,68,80,93,16,4,49,52,340
57,Christian Braun\braunch01,SG,22,DEN,44,0,844,122,268,0.455,31,83,0.373,91,185,0.492,0.513,56,78,0.718,30,126,156,67,16,17,33,70,331
58,Mikal Bridges\bridgmi01,SF,27,BRK,42,42,1462,314,695,0.452,90,254,0.354,224,441,0.508,0.517,181,215,0.842,38,182,220,157,37,20,99,68,899
59,Miles Bridges\bridgmi02,SF,25,CHO,29,27,1066,228,494,0.462,66,184,0.359,162,310,0.523,0.528,76,88,0.864,23,183,206,86,30,15,59,58,598
60,Oshae Brissett\brissos01,SF,25,BOS,26,0,314,37,80,0.463,10,33,0.303,27,47,0.574,0.525,26,38,0.684,30,49,79,17,12,2,9,31,110
61,Malcolm Brogdon\brogdma01,PG,31,POR,33,19,902,181,413,0.438,71,169,0.42,110,244,0.451,0.524,78,97,0.804,21,98,119,174,23,6,43,45,511
62,Armoni Brooks\brookar01,PG,25,BRK,10,0,104,15,46,0.326,11,32,0.344,4,14,0.286,0.446,1,2,0.5,7,11,18,5,1,1,3,3,42
63,Dillon Brooks\brookdi01,SF,28,HOU,33,33,1038,166,359,0.462,62,158,0.392,104,201,0.517,0.549,59,71,0.831,24,92,116,50,34,2,50,121,453
64,Bruce Brown\brownbr01,SG-PG,27,TOT,35,33,1028,159,332,0.479,34,106,0.321,125,226,0.553,0.53,69,84,0.821,28,136,164,101,37,9,43,87,421
64,Bruce Brown\brownbr01,SG,27,IND,33,33,981,149,314,0.475,33,101,0.327,116,213,0.545,0.527,67,82,0.817,25,129,154,100,35,8,41,81,398
64,Bruce Brown\brownbr01,PG,27,TOR,2,0,47,10,18,0.556,1,5,0.2,9,13,0.692,0.583,2,2,1.0,3,7,10,1,2,1,2,6,23
65,Charlie Brown Jr.\brownch02,SG,26,NYK,3,0,5,1,4,0.25,1,3,0.333,0,1,0.0,0.375,0,0,,0,0,0,0,0,0,2,0,3
66,Greg Brown III\browngr01,PF,22,DAL,6,0,40,5,11,0.455,1,3,0.333,4,8,0.5,0.5,4,9,0.444,3,6,9,4,0,4,4,5,15
67,Jaylen Brown\brownja02,SF,27,BOS,40,40,1339,351,716,0.49,86,239,0.36,265,477,0.556,0.55,124,172,0.721,36,176,212,145,45,24,102,103,912
68,Kendall Brown\brownke03,SG,20,IND,3,0,17,2,5,0.4,0,1,0.0,2,4,0.5,0.4,4,6,0.667,2,0,2,1,0,0,0,4,8
69,Kobe Brown\brownko01,PF,24,LAC,25,0,250,22,56,0.393,11,36,0.306,11,20,0.55,0.491,1,2,0.5,6,29,35,15,6,3,4,37,56
70,Moses Brown\brownmo01,C,24,POR,9,4,82,9,21,0.429,0,0,,9,21,0.429,0.429,0,4,0.0,18,28,46,2,2,3,4,11,18
71,Troy Brown Jr.\browntr01,SF,24,MIN,34,3,393,50,113,0.442,30,81,0.37,20,32,0.625,0.575,19,22,0.864,14,55,69,33,8,2,18,24,149
72,Jalen Brunson\brunsja01,PG,27,NYK,41,41,1468,382,805,0.475,117,274,0.427,265,531,0.499,0.547,207,249,0.831,26,135,161,268,40,8,100,87,1088
73,Thomas Bryant\bryanth01,C,26,MIA,22,3,237,41,73,0.562,0,3,0.0,41,70,0.586,0.562,17,20,0.85,22,49,71,13,6,5,15,24,99
74,Kobe Bufkin\bufkiko01,SG,20,ATL,2,0,4,0,3,0.0,0,1,0.0,0,2,0.0,0.0,1,2,0.5,1,1,2,0,0,0,0,0,1
75,Reggie Bullock\bullore01,SF,32,HOU,17,0,158,14,35,0.4,10,26,0.385,4,9,0.444,0.543,1,1,1.0,2,22,24,9,2,2,4,9,39
76,Alec Burks\burksal01,SG,32,DET,35,0,705,133,335,0.397,81,201,0.403,52,134,0.388,0.518,99,110,0.9,15,67,82,52,16,9,24,52,446
77,Jared Butler\butleja02,SG,23,WAS,17,0,128,28,50,0.56,10,24,0.417,18,26,0.692,0.66,12,15,0.8,0,11,11,31,8,2,10,14,78
78,Jimmy Butler\butleji01,PF,34,MIA,28,28,942,183,379,0.483,23,58,0.397,160,321,0.498,0.513,201,227,0.885,53,87,140,124,31,10,49,32,590
79,Jamal Cain\cainja01,PF,24,MIA,14,1,209,29,66,0.439,8,25,0.32,21,41,0.512,0.5,14,19,0.737,12,17,29,3,9,4,4,16,80
80,Kentavious Caldwell-Pope\caldwke01,SG,30,DEN,42,42,1362,150,328,0.457,63,158,0.399,87,170,0.512,0.553,61,68,0.897,18,80,98,105,62,22,43,78,424
81,Toumani Camara\camarto01,PF,23,POR,41,29,1015,106,257,0.412,32,114,0.281,74,143,0.517,0.475,40,59,0.678,79,122,201,39,40,21,49,109,284
82,Clint Capela\capelca01,C,29,ATL,40,40,1039,188,325,0.578,0,0,,188,325,0.578,0.578,71,109,0.651,190,224,414,39,26,66,36,102,447
83,Jevon Carter\carteje01,PG,28,CHI,42,0,600,87,232,0.375,52,149,0.349,35,83,0.422,0.487,3,5,0.6,5,27,32,52,21,11,23,47,229
84,Wendell Carter Jr.\cartewe01,C,24,ORL,17,11,420,66,129,0.512,19,44,0.432,47,85,0.553,0.585,31,41,0.756,31,80,111,28,7,9,20,35,182
85,Alex Caruso\carusal01,SG,29,CHI,37,25,943,128,259,0.494,63,151,0.417,65,108,0.602,0.616,43,56,0.768,36,94,130,96,50,33,47,85,362
86,Colin Castleton\castlco01,C,23,LAL,5,0,32,6,9,0.667,0,0,,6,9,0.667,0.667,4,4,1.0,4,5,9,3,0,0,1,6,16
87,Malcolm Cazalon\cazalma01,SG,22,DET,1,0,3,0,0,,0,0,,0,0,,,0,0,,0,0,0,0,0,0,0,0,0
88,Julian Champagnie\champju02,SF,22,SAS,35,20,542,69,168,0.411,49,124,0.395,20,44,0.455,0.557,27,31,0.871,14,63,77,34,20,19,24,38,214
89,Max Christie\chrisma02,SG,20,LAL,34,6,600,63,155,0.406,25,76,0.329,38,79,0.481,0.487,22,28,0.786,9,87,96,37,13,9,28,47,173
90,Sidy Cissoko\cissosi01,SF,19,SAS,5,0,32,1,6,0.167,0,4,0.0,1,2,0.5,0.167,4,4,1.0,0,6,6,0,3,0,1,2,6
91,Jordan Clarkson\clarkjo01,SG,31,UTA,34,19,1032,222,528,0.42,62,195,0.318,160,333,0.48,0.479,117,132,0.886,37,91,128,174,23,5,98,46,623
92,Nic Claxton\claxtni01,C,24,BRK,32,32,929,173,269,0.643,1,2,0.5,172,267,0.644,0.645,54,94,0.574,98,225,323,56,20,72,35,83,401
93,Noah Clowney\clownno01,PF,19,BRK,2,0,27,6,9,0.667,0,1,0.0,6,8,0.75,0.667,2,2,1.0,3,2,5,2,0,0,1,3,14
94,Amir Coffey\coffeam01,SF,26,LAC,29,6,447,49,89,0.551,18,45,0.4,31,44,0.705,0.652,13,16,0.813,11,35,46,19,9,0,12,31,129
95,John Collins\collijo01,PF,26,UTA,40,38,1104,211,421,0.501,53,146,0.363,158,275,0.575,0.564,76,96,0.792,79,224,303,40,23,30,59,108,551
96,Zach Collins\colliza01,C,26,SAS,33,24,856,163,328,0.497,35,113,0.31,128,215,0.595,0.55,64,83,0.771,62,130,192,109,19,24,76,111,425
97,Mike Conley\conlemi01,PG,36,MIN,41,41,1196,151,339,0.445,96,219,0.438,55,120,0.458,0.587,48,52,0.923,15,98,113,264,39,7,44,69,446
98,Pat Connaughton\connapa01,SF,31,MIL,36,0,783,71,161,0.441,43,116,0.371,28,45,0.622,0.575,14,19,0.737,24,97,121,65,15,7,20,44,199
99,Bilal Coulibaly\coulibi01,SF,19,WAS,41,1,1079,125,264,0.473,43,108,0.398,82,156,0.526,0.555,48,74,0.649,34,139,173,74,34,34,55,88,341
100,Ricky Council IV\councri01,SG,22,PHI,3,0,8,0,1,0.0,0,1,0.0,0,0,,0.0,1,2,0.5,0,0,0,0,0,0,0,1,1
101,Robert Covington\covinro01,SF-PF,33,TOT,29,6,488,43,98,0.439,19,56,0.339,24,42,0.571,0.536,22,26,0.846,31,66,97,24,39,18,11,56,127
101,Robert Covington\covinro01,PF,33,LAC,3,3,69,3,9,0.333,2,8,0.25,1,1,1.0,0.444,1,2,0.5,2,6,8,7,6,2,0,7,9
101,Robert Covington\covinro01,SF,33,PHI,26,3,419,40,89,0.449,17,48,0.354,23,41,0.561,0.545,21,24,0.875,29,60,89,17,33,16,11,49,118
102,Torrey Craig\craigto01,SF,33,CHI,27,7,572,59,139,0.424,29,76,0.382,30,63,0.476,0.529,18,23,0.783,50,80,130,28,17,10,16,68,165
103,Jae Crowder\crowdja01,PF,33,MIL,11,2,273,31,63,0.492,20,43,0.465,11,20,0.55,0.651,8,14,0.571,4,34,38,15,9,3,4,17,90
104,Cade Cunningham\cunnica01,PG,22,DET,36,36,1241,307,684,0.449,67,200,0.335,240,484,0.496,0.498,141,162,0.87,16,130,146,261,35,12,136,100,822
105,Seth Curry\curryse01,SG,33,DAL,33,3,424,48,132,0.364,28,74,0.378,20,58,0.345,0.47,14,16,0.875,13,34,47,26,17,3,14,31,138
106,Stephen Curry\curryst01,PG,35,GSW,37,37,1228,313,702,0.446,167,421,0.397,146,281,0.52,0.565,195,211,0.924,17,139,156,181,32,15,113,68,988
107,Dyson Daniels\daniedy01,PG,20,NOP,43,14,958,96,224,0.429,27,97,0.278,69,127,0.543,0.489,31,48,0.646,44,120,164,116,57,13,40,72,250
108,Anthony Davis\davisan02,C,30,LAL,42,42,1506,394,707,0.557,14,45,0.311,380,662,0.574,0.567,245,301,0.814,132,380,512,157,51,102,92,106,1047
109,Johnny Davis\davisjo06,SG,21,WAS,19,0,150,21,48,0.438,1,3,0.333,20,45,0.444,0.448,4,5,0.8,9,11,20,5,7,1,5,11,47
110,JD Davison\davisjd01,SG,21,BOS,2,0,6,0,1,0.0,0,1,0.0,0,0,,0.0,2,2,1.0,1,1,2,0,0,0,0,0,2
111,Dexter Dennis\dennide01,SG,24,DAL,4,0,30,10,19,0.526,1,8,0.125,9,11,0.818,0.553,1,3,0.333,1,8,9,4,0,1,3,1,22
112,DeMar DeRozan\derozde01,SF,34,CHI,42,42,1554,323,701,0.461,41,121,0.339,282,580,0.486,0.49,234,276,0.848,24,145,169,224,46,28,60,91,921
113,Moussa Diabaté\diabamo01,C,22,LAC,10,0,58,9,18,0.5,0,0,,9,18,0.5,0.5,9,12,0.75,14,6,20,4,4,0,2,4,27
114,Mamadi Diakite\diakima01,PF,27,SAS,3,0,16,4,5,0.8,0,0,,4,5,0.8,0.8,4,6,0.667,1,2,3,2,0,1,0,1,12
115,Hamidou Diallo\diallha01,SG,25,WAS,2,0,5,1,2,0.5,0,0,,1,2,0.5,0.5,0,0,,2,0,2,1,2,0,1,1,2
116,Gradey Dick\dickgr01,SG,20,TOR,22,1,275,26,80,0.325,16,54,0.296,10,26,0.385,0.425,15,15,1.0,7,18,25,22,9,0,14,28,83
117,Ousmane Dieng\diengou01,PF,20,OKC,22,0,250,33,78,0.423,16,52,0.308,17,26,0.654,0.526,10,12,0.833,9,32,41,19,2,0,10,16,92
118,Spencer Dinwiddie\dinwisp01,PG,30,BRK,40,40,1232,173,434,0.399,81,243,0.333,92,191,0.482,0.492,114,145,0.786,24,119,143,244,34,8,59,69,541
119,Donte DiVincenzo\divindo01,SG,27,NYK,43,25,953,169,368,0.459,112,266,0.421,57,102,0.559,0.611,37,52,0.712,31,103,134,93,48,13,47,83,487
120,Luka Dončić\doncilu01,PG,24,DAL,35,35,1287,400,824,0.485,137,364,0.376,263,460,0.572,0.569,238,306,0.778,24,265,289,321,49,21,138,60,1175
121,Luguentz Dort\dortlu01,SF,24,OKC,40,40,1151,153,331,0.462,79,186,0.425,74,145,0.51,0.582,71,87,0.816,51,107,158,54,35,31,37,123,456
122,Ayo Dosunmu\dosunay01,SG,24,CHI,42,6,972,140,292,0.479,45,120,0.375,95,172,0.552,0.557,39,48,0.813,28,78,106,89,29,15,37,80,364
123,Andre Drummond\drumman01,C,30,CHI,44,7,703,135,246,0.549,0,2,0.0,135,244,0.553,0.549,65,117,0.556,145,226,371,25,53,27,50,78,335
124,Chris Duarte\duartch01,SF,26,SAC,34,11,458,45,125,0.36,21,67,0.313,24,58,0.414,0.444,18,24,0.75,13,51,64,32,18,2,20,61,129
125,Kris Dunn\dunnkr01,PG,29,UTA,36,18,633,75,158,0.475,18,48,0.375,57,110,0.518,0.532,12,18,0.667,23,82,105,153,32,16,44,68,180
126,Kevin Durant\duranke01,PF,35,PHO,35,35,1294,362,680,0.532,79,168,0.47,283,512,0.553,0.59,218,247,0.883,17,204,221,195,30,42,113,65,1021
127,Jalen Duren\durenja01,C,20,DET,27,26,805,168,260,0.646,0,2,0.0,168,258,0.651,0.646,43,62,0.694,88,221,309,69,12,25,56,88,379
128,Tari Eason\easonta01,PF,22,HOU,22,0,480,88,189,0.466,18,50,0.36,70,139,0.504,0.513,21,33,0.636,46,107,153,27,31,19,20,51,215
129,Anthony Edwards\edwaran01,SG,22,MIN,39,39,1356,349,748,0.467,94,248,0.379,255,500,0.51,0.529,218,260,0.838,26,183,209,196,49,22,135,73,1010
130,Kessler Edwards\edwarke02,SF,23,SAC,28,0,138,17,41,0.415,9,25,0.36,8,16,0.5,0.524,3,4,0.75,5,16,21,7,2,2,1,10,46
131,Keon Ellis\elliske01,SG,24,SAC,28,3,342,36,83,0.434,26,68,0.382,10,15,0.667,0.59,11,17,0.647,9,28,37,35,14,12,15,39,109
132,Joel Embiid\embiijo01,C,29,PHI,31,31,1059,362,675,0.536,36,100,0.36,326,575,0.567,0.563,326,368,0.886,78,274,352,183,36,59,115,90,1086
133,Drew Eubanks\eubandr01,C,26,PHO,36,2,561,78,133,0.586,3,3,1.0,75,130,0.577,0.598,40,53,0.755,50,98,148,31,12,31,37,62,199
134,Dante Exum\exumda01,PG,28,DAL,30,14,586,111,193,0.575,28,62,0.452,83,131,0.634,0.648,30,40,0.75,18,69,87,86,18,5,26,48,280
135,Bruno Fernando\fernabr01,C,25,ATL,13,0,84,14,27,0.519,0,3,0.0,14,24,0.583,0.519,10,19,0.526,7,19,26,4,2,5,7,12,38
136,Dorian Finney-Smith\finnedo01,PF,30,BRK,39,28,1108,128,312,0.41,81,210,0.386,47,102,0.461,0.54,13,16,0.813,70,121,191,48,28,23,29,87,350
137,Malachi Flynn\flynnma01,PG,25,TOT,38,0,505,61,149,0.409,30,88,0.341,31,61,0.508,0.51,21,28,0.75,13,55,68,77,19,6,35,45,173
137,Malachi Flynn\flynnma01,PG,25,TOR,31,0,474,56,137,0.409,28,80,0.35,28,57,0.491,0.511,17,22,0.773,13,52,65,73,18,6,33,42,157
137,Malachi Flynn\flynnma01,PG,25,NYK,7,0,31,5,12,0.417,2,8,0.25,3,4,0.75,0.5,4,6,0.667,0,3,3,4,1,0,2,3,16
138,Simone Fontecchio\fontesi01,SF,28,UTA,42,26,959,134,298,0.45,76,195,0.39,58,103,0.563,0.577,29,37,0.784,40,99,139,59,25,16,46,72,373
139,Jordan Ford\fordjo01,PG,25,SAC,6,0,22,4,7,0.571,2,3,0.667,2,4,0.5,0.714,2,2,1.0,0,2,2,2,0,0,1,0,12
140,Trent Forrest\forretr01,SG,25,ATL,16,0,173,15,42,0.357,2,6,0.333,13,36,0.361,0.381,8,10,0.8,5,19,24,29,5,1,9,14,40
141,Evan Fournier\fournev01,SG,31,NYK,3,0,39,4,20,0.2,2,15,0.133,2,5,0.4,0.25,2,2,1.0,0,4,4,3,4,0,1,4,12
142,De'Aaron Fox\foxde01,PG,26,SAC,35,35,1247,346,739,0.468,114,287,0.397,232,452,0.513,0.545,170,237,0.717,32,114,146,202,56,13,90,89,976
143,Javon Freeman-Liberty\freemja01,PG,24,TOR,1,0,2,1,3,0.333,0,0,,1,3,0.333,0.333,0,0,,1,0,1,0,0,0,0,0,2
144,Alex Fudge\fudgeal01,SF,20,LAL,4,0,14,1,6,0.167,0,2,0.0,1,4,0.25,0.167,2,2,1.0,2,0,2,0,0,0,1,1,4
145,Markelle Fultz\fultzma01,PG,25,ORL,12,6,292,47,97,0.485,0,3,0.0,47,94,0.5,0.485,5,11,0.455,15,21,36,44,14,5,16,21,99
146,Daniel Gafford\gaffoda01,C,25,WAS,37,37,969,159,232,0.685,0,0,,159,232,0.685,0.685,72,99,0.727,98,182,280,59,34,78,40,122,390
147,Danilo Gallinari\gallida01,PF-SF,35,TOT,27,0,401,58,132,0.439,21,65,0.323,37,67,0.552,0.519,52,61,0.852,12,65,77,34,6,3,12,26,189
147,Danilo Gallinari\gallida01,PF,35,WAS,26,0,385,57,131,0.435,20,64,0.313,37,67,0.552,0.511,47,56,0.839,12,64,76,31,6,3,12,26,181
147,Danilo Gallinari\gallida01,SF,35,DET,1,0,16,1,1,1.0,1,1,1.0,0,0,,1.5,5,5,1.0,0,1,1,3,0,0,0,0,8
148,Darius Garland\garlada01,PG,24,CLE,20,20,680,151,321,0.47,36,104,0.346,115,217,0.53,0.526,76,91,0.835,12,43,55,118,32,4,76,31,414
149,Usman Garuba\garubus01,PF,21,GSW,2,0,6,0,1,0.0,0,0,,0,1,0.0,0.0,0,0,,0,0,0,1,1,0,0,1,0
150,Luka Garza\garzalu01,C,25,MIN,8,0,22,5,16,0.313,0,5,0.0,5,11,0.455,0.313,5,8,0.625,4,4,8,2,0,0,2,7,15
151,Kaiser Gates\gateska01,SF,27,NOP,1,0,7,0,4,0.0,0,2,0.0,0,2,0.0,0.0,0,0,,0,1,1,0,0,0,0,0,0
152,Keyonte George\georgke01,PG,20,UTA,38,16,922,130,349,0.372,65,197,0.33,65,152,0.428,0.466,87,108,0.806,13,94,107,165,17,3,79,39,412
153,Paul George\georgpa01,PF,33,LAC,39,39,1358,324,698,0.464,141,337,0.418,183,361,0.507,0.565,133,146,0.911,24,193,217,142,63,13,81,115,922
154,Taj Gibson\gibsota01,PF,38,NYK,10,0,97,7,14,0.5,0,4,0.0,7,10,0.7,0.5,0,0,,6,12,18,5,1,6,2,20,14
155,Josh Giddey\giddejo01,SG,21,OKC,41,41,1023,198,437,0.453,40,116,0.345,158,321,0.492,0.499,49,60,0.817,55,201,256,190,31,18,89,53,485
156,Harry Giles\gilesha01,C,25,BRK,12,0,67,18,36,0.5,1,8,0.125,17,28,0.607,0.514,6,11,0.545,9,10,19,3,1,3,4,9,43
157,Shai Gilgeous-Alexander\gilgesh01,PG,25,OKC,41,41,1415,452,823,0.549,46,141,0.326,406,682,0.595,0.577,324,363,0.893,34,196,230,257,91,32,82,105,1274
158,Anthony Gill\gillan01,PF,31,WAS,24,0,147,22,45,0.489,2,11,0.182,20,34,0.588,0.511,12,16,0.75,13,21,34,10,3,6,11,12,58
159,Collin Gillespie\gilleco01,PG,24,DEN,14,0,97,11,24,0.458,4,13,0.308,7,11,0.636,0.542,4,5,0.8,1,4,5,9,5,0,5,12,30
160,Jacob Gilyard\gilyaja01,PG,25,MEM,25,9,410,33,84,0.393,28,69,0.406,5,15,0.333,0.56,1,1,1.0,7,20,27,81,16,3,15,24,95
161,Rudy Gobert\goberru01,C,31,MIN,41,41,1347,203,324,0.627,0,2,0.0,203,322,0.63,0.627,135,215,0.628,144,368,512,50,27,87,68,119,541
162,Jordan Goodwin\goodwjo01,PG,25,PHO,35,0,542,68,183,0.372,23,79,0.291,45,104,0.433,0.434,23,27,0.852,39,77,116,76,21,8,29,42,182
163,Aaron Gordon\gordoaa01,PF,28,DEN,38,38,1220,208,384,0.542,20,70,0.286,188,314,0.599,0.568,84,137,0.613,103,155,258,120,31,23,52,66,520
164,Eric Gordon\gordoer01,SG,35,PHO,36,19,1095,166,375,0.443,89,237,0.376,77,138,0.558,0.561,28,36,0.778,11,66,77,83,34,18,45,48,449
165,Devonte' Graham\grahade01,PG,28,SAS,9,0,83,10,26,0.385,6,18,0.333,4,8,0.5,0.5,6,8,0.75,2,9,11,19,3,1,3,4,32
166,Jerami Grant\grantje01,PF,29,POR,37,37,1254,281,612,0.459,81,201,0.403,200,411,0.487,0.525,159,198,0.803,26,106,132,90,28,27,76,84,802
167,A.J. Green\greenaj01,SG,24,MIL,26,0,204,30,70,0.429,25,60,0.417,5,10,0.5,0.607,4,4,1.0,5,16,21,16,0,1,0,23,89
168,Danny Green\greenda02,SG,36,PHI,2,0,18,0,2,0.0,0,1,0.0,0,1,0.0,0.0,0,0,,0,2,2,1,1,0,0,1,0
169,Draymond Green\greendr01,PF,33,GSW,16,15,401,53,108,0.491,19,43,0.442,34,65,0.523,0.579,27,32,0.844,22,68,90,91,7,11,39,49,152
170,Jalen Green\greenja05,SG,21,HOU,42,42,1271,242,609,0.397,86,269,0.32,156,340,0.459,0.468,148,186,0.796,16,176,192,134,25,12,92,55,718
171,Jeff Green\greenje02,PF,37,HOU,40,1,654,86,165,0.521,16,50,0.32,70,115,0.609,0.57,75,91,0.824,27,56,83,30,5,20,28,59,263
172,Josh Green\greenjo02,SG,23,DAL,29,12,740,81,175,0.463,32,87,0.368,49,88,0.557,0.554,18,32,0.563,16,70,86,73,23,5,27,52,212
173,AJ Griffin\griffaj01,SF,20,ATL,16,0,129,13,42,0.31,9,31,0.29,4,11,0.364,0.417,2,2,1.0,2,11,13,4,1,1,6,6,37
174,Quentin Grimes\grimequ01,SG,23,NYK,40,18,790,94,243,0.387,69,186,0.371,25,57,0.439,0.529,15,21,0.714,13,57,70,45,27,3,19,60,272
175,Mouhamed Gueye\gueyemo02,PF,21,ATL,2,0,4,0,1,0.0,0,1,0.0,0,0,,0.0,0,0,,0,0,0,0,1,0,0,1,0
176,Rui Hachimura\hachiru01,PF,25,LAL,30,6,686,127,270,0.47,32,91,0.352,95,179,0.531,0.53,48,63,0.762,24,80,104,32,22,7,23,40,334
177,Tyrese Haliburton\halibty01,PG,23,IND,34,34,1136,284,573,0.496,114,285,0.4,170,288,0.59,0.595,119,138,0.862,21,120,141,428,37,22,84,36,801
178,R.J. Hampton\hamptrj01,PG,22,MIA,8,2,76,4,14,0.286,1,8,0.125,3,6,0.5,0.321,1,2,0.5,2,4,6,8,0,0,3,8,10
179,Tim Hardaway Jr.\hardati02,SF,31,DAL,39,8,1156,240,574,0.418,126,348,0.362,114,226,0.504,0.528,100,114,0.877,14,128,142,66,17,1,38,57,706
180,James Harden\hardeja01,PG,34,LAC,36,36,1228,182,400,0.455,98,233,0.421,84,167,0.503,0.578,155,176,0.881,11,154,165,305,45,31,97,75,617
181,Jaden Hardy\hardyja02,SG,21,DAL,37,4,586,106,279,0.38,49,143,0.343,57,136,0.419,0.468,28,41,0.683,11,67,78,59,12,2,28,45,289
182,Ron Harper Jr.\harpero02,PF,23,TOR,1,0,4,0,0,,0,0,,0,0,,,0,0,,0,0,0,1,0,0,0,2,0
183,Gary Harris\harriga01,SG,29,ORL,27,6,616,66,154,0.429,36,108,0.333,30,46,0.652,0.545,24,31,0.774,13,33,46,50,23,5,14,47,192
184,Joe Harris\harrijo01,SG,32,DET,15,0,158,13,36,0.361,10,29,0.345,3,7,0.429,0.5,1,2,0.5,3,10,13,10,3,2,4,18,37
185,Kevon Harris\harrike01,SG,26,ORL,1,0,3,0,0,,0,0,,0,0,,,0,0,,0,1,1,0,0,0,1,1,0
186,Tobias Harris\harrito02,PF,31,PHI,40,40,1363,268,525,0.51,51,137,0.372,217,388,0.559,0.559,125,139,0.899,41,201,242,126,39,22,61,66,712
187,Shaquille Harrison\harrish01,SG,30,MEM,3,0,6,1,2,0.5,0,0,,1,2,0.5,0.5,0,0,,0,2,2,0,0,1,0,0,2
188,Josh Hart\hartjo01,SF,28,NYK,42,6,1181,121,273,0.443,38,116,0.328,83,157,0.529,0.513,29,36,0.806,53,219,272,113,31,9,51,81,309
189,Isaiah Hartenstein\harteis01,C,25,NYK,43,17,1099,112,185,0.605,1,3,0.333,111,182,0.61,0.608,59,85,0.694,141,224,365,84,50,48,51,125,284
190,Sam Hauser\hausesa01,SF,26,BOS,42,5,921,119,274,0.434,95,236,0.403,24,38,0.632,0.608,11,13,0.846,30,126,156,44,18,12,21,58,344
191,Jordan Hawkins\hawkijo01,SG,21,NOP,38,10,833,139,336,0.414,85,217,0.392,54,119,0.454,0.54,56,67,0.836,22,84,106,53,14,3,30,56,419
192,Jaxson Hayes\hayesja02,C,23,LAL,35,1,340,43,65,0.662,0,5,0.0,43,60,0.717,0.662,15,28,0.536,16,44,60,12,7,12,18,63,101
193,Killian Hayes\hayeski01,PG,22,DET,37,27,913,109,267,0.408,19,68,0.279,90,199,0.452,0.444,32,47,0.681,11,92,103,180,35,17,45,69,269
194,Gordon Hayward\haywago01,SF,33,CHO,25,25,798,139,297,0.468,22,61,0.361,117,236,0.496,0.505,62,81,0.765,25,92,117,116,28,12,51,46,362
195,Scoot Henderson\hendesc01,PG,19,POR,33,15,902,145,398,0.364,38,130,0.292,107,268,0.399,0.412,75,100,0.75,30,70,100,156,20,8,108,104,403
196,Taylor Hendricks\hendrita01,PF,20,UTA,13,0,181,23,58,0.397,12,35,0.343,11,23,0.478,0.5,6,8,0.75,11,18,29,6,9,7,9,12,64
197,Tyler Herro\herroty01,SG,24,MIA,24,24,817,197,453,0.435,79,197,0.401,118,256,0.461,0.522,56,66,0.848,15,118,133,99,28,2,59,39,529
198,Buddy Hield\hieldbu01,SF,31,IND,43,22,1125,203,456,0.445,124,317,0.391,79,139,0.568,0.581,27,32,0.844,30,112,142,115,33,27,57,88,557
199,Haywood Highsmith\highsha01,PF,27,MIA,29,17,617,60,145,0.414,31,85,0.365,29,60,0.483,0.521,18,23,0.783,24,60,84,36,30,15,20,57,169
200,Nate Hinton\hintona01,SG,24,HOU,5,0,26,4,9,0.444,4,5,0.8,0,4,0.0,0.667,0,0,,2,3,5,1,0,0,1,5,12
201,D'Moi Hodge\hodgedm01,SG,25,LAL,7,0,41,5,15,0.333,3,12,0.25,2,3,0.667,0.433,1,2,0.5,0,0,0,5,1,1,1,4,14
202,Aaron Holiday\holidaa01,PG,27,HOU,40,1,671,94,212,0.443,46,116,0.397,48,96,0.5,0.552,25,28,0.893,10,64,74,65,22,3,29,61,259
203,Jrue Holiday\holidjr01,PG,33,BOS,39,39,1313,194,426,0.455,77,184,0.418,117,242,0.483,0.546,46,56,0.821,58,183,241,179,32,29,74,64,511
204,Justin Holiday\holidju01,SG,34,DEN,25,6,326,33,67,0.493,21,47,0.447,12,20,0.6,0.649,0,0,,4,25,29,25,14,1,6,28,87
205,Richaun Holmes\holmeri01,C,30,DAL,17,1,172,23,46,0.5,0,0,,23,46,0.5,0.5,9,18,0.5,26,35,61,9,2,6,10,22,55
206,Chet Holmgren\holmgch01,C,21,OKC,42,42,1264,273,504,0.542,68,176,0.386,205,328,0.625,0.609,113,142,0.796,60,241,301,118,27,105,72,115,727
207,Jalen Hood-Schifino\hoodsja01,SG,20,LAL,11,0,84,8,33,0.242,1,9,0.111,7,24,0.292,0.258,7,12,0.583,2,8,10,7,3,1,7,10,24
208,Al Horford\horfoal01,C,37,BOS,35,16,947,102,209,0.488,56,136,0.412,46,73,0.63,0.622,12,14,0.857,49,192,241,99,16,35,28,57,272
209,Talen Horton-Tucker\hortota01,PG,23,UTA,30,11,659,123,299,0.411,37,111,0.333,86,188,0.457,0.473,48,61,0.787,12,64,76,126,32,11,51,62,331
210,Danuel House Jr.\houseda01,SF,30,PHI,26,0,343,31,71,0.437,13,36,0.361,18,35,0.514,0.528,19,25,0.76,10,29,39,20,8,2,16,29,94
211,Caleb Houstan\houstca01,SF,21,ORL,34,7,537,54,145,0.372,47,135,0.348,7,10,0.7,0.534,17,22,0.773,21,38,59,23,10,1,12,42,172
212,Jett Howard\howarje01,SF,20,ORL,11,0,42,7,19,0.368,4,14,0.286,3,5,0.6,0.474,2,4,0.5,1,4,5,3,0,1,2,1,20
213,Kevin Huerter\huertke01,SG,25,SAC,39,34,929,153,348,0.44,76,212,0.358,77,136,0.566,0.549,27,33,0.818,19,124,143,99,25,13,23,84,409
214,Jay Huff\huffja01,C,25,DEN,5,0,12,2,4,0.5,0,2,0.0,2,2,1.0,0.5,0,0,,0,1,1,1,0,0,1,3,4
215,De'Andre Hunter\huntede01,SF,26,ATL,24,24,727,122,265,0.46,46,114,0.404,76,151,0.503,0.547,68,75,0.907,15,83,98,33,20,9,37,73,358
216,Bones Hyland\hylanbo01,PG,23,LAC,16,2,234,42,107,0.393,20,55,0.364,22,52,0.423,0.486,10,12,0.833,2,13,15,28,8,1,20,23,114
217,Joe Ingles\inglejo01,SF,36,ORL,29,0,537,50,123,0.407,32,78,0.41,18,45,0.4,0.537,17,20,0.85,12,63,75,101,22,3,29,47,149
218,Brandon Ingram\ingrabr01,SF,26,NOP,39,39,1293,309,633,0.488,55,154,0.357,254,479,0.53,0.532,164,202,0.812,23,165,188,221,33,17,95,88,837
219,Kyrie Irving\irvinky01,SG,31,DAL,26,26,864,241,510,0.473,75,183,0.41,166,327,0.508,0.546,100,112,0.893,21,110,131,140,34,12,43,47,657
220,Jonathan Isaac\isaacjo01,PF,26,ORL,26,0,352,56,123,0.455,15,53,0.283,41,70,0.586,0.516,33,42,0.786,28,74,102,11,20,29,12,31,160
221,Jaden Ivey\iveyja01,SG,21,DET,38,22,1005,191,419,0.456,49,154,0.318,142,265,0.536,0.514,114,157,0.726,51,94,145,139,29,24,87,108,545
222,Andre Jackson Jr.\jacksan01,SG,22,MIL,36,8,411,39,73,0.534,13,34,0.382,26,39,0.667,0.623,6,7,0.857,36,47,83,35,9,3,19,68,97
223,Gregory Jackson II\jacksgg01,PF,19,MEM,10,0,115,21,46,0.457,11,23,0.478,10,23,0.435,0.576,13,19,0.684,9,15,24,3,3,5,6,10,66
224,Isaiah Jackson\jacksis01,C,22,IND,33,1,454,94,139,0.676,0,2,0.0,94,137,0.686,0.676,43,62,0.694,50,88,138,30,22,41,24,93,231
225,Jaren Jackson Jr.\jacksja02,C,24,MEM,40,40,1261,294,647,0.454,72,217,0.332,222,430,0.516,0.51,207,247,0.838,51,176,227,73,36,66,78,141,867
226,Reggie Jackson\jacksre01,PG,33,DEN,44,14,1017,199,425,0.468,61,160,0.381,138,265,0.521,0.54,42,56,0.75,16,74,90,183,27,7,65,80,501
227,Trayce Jackson-Davis\jackstr02,PF,23,GSW,30,3,433,88,128,0.688,0,0,,88,128,0.688,0.688,34,55,0.618,51,78,129,31,11,25,23,50,210
228,LeBron James\jamesle01,PF,39,LAL,40,40,1371,370,712,0.52,86,220,0.391,284,492,0.577,0.58,165,223,0.74,37,252,289,297,53,23,134,43,991
229,Jaime Jaquez Jr.\jaqueja01,SF,22,MIA,39,15,1179,212,413,0.513,41,116,0.353,171,297,0.576,0.563,82,98,0.837,49,103,152,105,42,10,67,96,547
230,DaQuan Jeffries\jeffrda01,SG,26,NYK,10,0,30,5,12,0.417,1,5,0.2,4,7,0.571,0.458,0,2,0.0,0,5,5,2,0,0,1,2,11
231,Ty Jerome\jeromty01,SG,26,CLE,2,0,15,2,4,0.5,0,1,0.0,2,3,0.667,0.5,0,0,,1,0,1,3,0,0,1,2,4
232,Isaiah Joe\joeis01,SG,24,OKC,42,0,810,128,282,0.454,90,212,0.425,38,70,0.543,0.613,30,36,0.833,15,89,104,50,28,12,25,51,376
233,Cameron Johnson\johnsca02,PF,27,BRK,34,34,972,175,388,0.451,83,212,0.392,92,176,0.523,0.558,39,55,0.709,39,118,157,89,26,6,30,65,472
234,Jalen Johnson\johnsja05,SF,22,ATL,28,25,900,168,299,0.562,32,83,0.386,136,216,0.63,0.615,53,70,0.757,33,198,231,87,37,23,61,68,421
235,James Johnson\johnsja01,PF,36,IND,5,0,24,2,5,0.4,0,1,0.0,2,4,0.5,0.4,0,0,,1,3,4,5,4,0,2,4,4
236,Keldon Johnson\johnske04,SF,24,SAS,40,26,1250,245,543,0.451,76,218,0.349,169,325,0.52,0.521,120,154,0.779,52,184,236,140,33,9,67,99,686
237,Keon Johnson\johnske07,SG,21,BRK,1,0,21,3,8,0.375,2,4,0.5,1,4,0.25,0.5,4,4,1.0,0,1,1,1,1,1,1,1,12
238,Keyontae Johnson\johnske08,SF,23,OKC,2,0,23,2,6,0.333,0,1,0.0,2,5,0.4,0.333,0,0,,1,2,3,2,0,0,2,1,4
239,Nikola Jokić\jokicni01,C,28,DEN,43,43,1443,437,744,0.587,43,123,0.35,394,621,0.634,0.616,205,249,0.823,129,384,513,391,49,41,124,113,1122
240,Colby Jones\jonesco02,SG,21,SAC,15,0,110,16,42,0.381,1,13,0.077,15,29,0.517,0.393,2,3,0.667,9,12,21,9,4,1,5,15,35
241,Damian Jones\jonesda03,C,28,CLE,17,0,94,10,20,0.5,1,4,0.25,9,16,0.563,0.525,2,3,0.667,4,13,17,4,2,3,5,10,23
242,Derrick Jones Jr.\jonesde02,SF,26,DAL,40,39,1041,154,313,0.492,58,163,0.356,96,150,0.64,0.585,56,75,0.747,51,100,151,39,35,36,36,76,422
243,Herbert Jones\joneshe01,SF,25,NOP,40,40,1152,150,312,0.481,51,135,0.378,99,177,0.559,0.563,75,88,0.852,45,100,145,99,48,38,48,110,426
244,Tre Jones\jonestr01,PG,24,SAS,38,9,953,141,286,0.493,23,86,0.267,118,200,0.59,0.533,51,57,0.895,26,93,119,207,35,5,55,50,356
245,Tyus Jones\jonesty01,PG,27,WAS,42,42,1187,220,431,0.51,67,159,0.421,153,272,0.563,0.588,21,28,0.75,14,107,121,252,50,13,36,31,528
246,DeAndre Jordan\jordade01,C,35,DEN,20,1,251,37,57,0.649,0,0,,37,57,0.649,0.649,20,44,0.455,34,66,100,18,5,10,18,37,94
247,Cory Joseph\josepco01,PG,32,GSW,21,0,225,13,48,0.271,6,31,0.194,7,17,0.412,0.333,4,7,0.571,4,15,19,36,4,3,11,19,36
248,Nikola Jović\jovicni01,PF,20,MIA,17,12,310,36,88,0.409,18,43,0.419,18,45,0.4,0.511,11,20,0.55,15,64,79,36,6,7,17,37,101
249,Johnny Juzang\juzanjo01,SG,22,UTA,1,0,4,0,2,0.0,0,2,0.0,0,0,,0.0,0,0,,0,0,0,1,0,0,0,0,0
250,Luke Kennard\kennalu01,SG,27,MEM,19,7,453,62,142,0.437,47,109,0.431,15,33,0.455,0.602,17,18,0.944,8,51,59,53,9,1,14,19,188
251,Walker Kessler\kesslwa01,C,22,UTA,36,13,863,138,213,0.648,4,16,0.25,134,197,0.68,0.657,27,55,0.491,96,182,278,29,19,97,38,78,307
252,Braxton Key\keybr01,SF,26,DEN,13,0,44,5,14,0.357,1,4,0.25,4,10,0.4,0.393,4,5,0.8,2,8,10,8,2,0,1,4,15
253,Corey Kispert\kispeco01,SF,24,WAS,41,1,891,165,345,0.478,80,217,0.369,85,128,0.664,0.594,61,79,0.772,14,76,90,61,12,7,41,64,471
254,Maxi Kleber\klebima01,C,32,DAL,8,2,142,8,25,0.32,5,16,0.313,3,9,0.333,0.42,8,12,0.667,6,23,29,15,2,5,7,18,29
255,Kevin Knox\knoxke01,SF,24,DET,24,8,462,75,157,0.478,30,82,0.366,45,75,0.6,0.573,17,19,0.895,15,44,59,19,11,7,16,38,197
256,John Konchar\konchjo01,SF,27,MEM,33,4,554,36,101,0.356,19,65,0.292,17,36,0.472,0.45,9,11,0.818,31,94,125,49,23,24,16,33,100
257,Furkan Korkmaz\korkmfu01,SG,26,PHI,26,0,171,17,44,0.386,6,21,0.286,11,23,0.478,0.455,7,10,0.7,1,13,14,12,11,0,8,10,47
258,Luke Kornet\kornelu01,C,28,BOS,30,2,444,64,91,0.703,0,0,,64,91,0.703,0.703,21,24,0.875,55,58,113,27,13,31,13,40,149
259,Jonathan Kuminga\kuminjo01,PF,21,GSW,39,15,902,198,386,0.513,31,101,0.307,167,285,0.586,0.553,104,146,0.712,45,122,167,59,22,13,56,84,531
260,Kyle Kuzma\kuzmaky01,PF,28,WAS,42,42,1313,357,785,0.455,96,280,0.343,261,505,0.517,0.516,106,135,0.785,44,224,268,181,19,26,110,85,916
261,Jock Landale\landajo01,C,28,HOU,24,0,215,19,53,0.358,2,17,0.118,17,36,0.472,0.377,9,12,0.75,25,20,45,11,6,9,9,20,49
262,Jake LaRavia\laravja01,PF,22,MEM,11,0,122,16,43,0.372,5,24,0.208,11,19,0.579,0.43,3,4,0.75,7,9,16,6,1,1,4,19,40
263,Zach LaVine\lavinza01,SG,28,CHI,25,23,872,170,376,0.452,59,169,0.349,111,207,0.536,0.531,88,103,0.854,8,121,129,98,21,8,52,57,487
264,A.J. Lawson\lawsoaj01,SG,23,DAL,19,0,189,31,66,0.47,11,33,0.333,20,33,0.606,0.553,11,15,0.733,9,16,25,10,9,2,9,14,84
265,Saben Lee\leesa01,PG,24,PHO,10,0,69,8,19,0.421,0,4,0.0,8,15,0.533,0.421,13,17,0.765,5,5,10,11,3,3,4,6,29
266,Alex Len\lenal01,C,30,SAC,17,0,149,18,29,0.621,0,2,0.0,18,27,0.667,0.621,4,10,0.4,23,33,56,19,3,8,11,19,40
267,Kawhi Leonard\leonaka01,SF,32,LAC,37,37,1280,325,628,0.518,85,191,0.445,240,437,0.549,0.585,142,162,0.877,38,185,223,134,61,31,59,59,877
268,Caris LeVert\leverca01,SG,29,CLE,31,1,894,178,421,0.423,61,176,0.347,117,245,0.478,0.495,78,105,0.743,15,95,110,128,31,12,48,50,495
269,Kira Lewis Jr.\lewiski01,PG,22,NOP,15,0,144,16,52,0.308,2,20,0.1,14,32,0.438,0.327,10,11,0.909,4,10,14,18,5,1,8,8,44
270,Maxwell Lewis\lewisma05,SF,21,LAL,14,0,60,1,9,0.111,1,3,0.333,0,6,0.0,0.167,0,0,,1,2,3,3,2,0,5,2,3
271,E.J. Liddell\liddeej01,PF,23,NOP,6,0,17,1,5,0.2,0,4,0.0,1,1,1.0,0.2,2,2,1.0,0,3,3,1,0,2,2,2,4
272,Damian Lillard\lillada01,PG,33,MIL,39,39,1374,293,680,0.431,119,335,0.355,174,345,0.504,0.518,289,313,0.923,21,148,169,268,41,6,95,65,994
273,Nassir Little\littlna01,SF,23,PHO,25,2,368,45,93,0.484,16,51,0.314,29,42,0.69,0.57,17,20,0.85,14,46,60,16,10,8,12,31,123
274,Dereck Lively II\livelde01,C,19,DAL,31,30,786,125,170,0.735,0,2,0.0,125,168,0.744,0.735,25,44,0.568,90,153,243,40,19,42,37,92,275
275,Isaiah Livers\liveris01,PF,25,DET,23,6,469,40,116,0.345,22,77,0.286,18,39,0.462,0.44,12,18,0.667,15,33,48,25,13,5,16,43,114
276,Chris Livingston\livinch01,SF,20,MIL,12,0,58,7,12,0.583,1,1,1.0,6,11,0.545,0.625,2,2,1.0,2,10,12,4,2,0,3,5,17
277,Kenneth Lofton Jr.\loftoke01,PF,21,TOT,16,0,103,14,39,0.359,3,10,0.3,11,29,0.379,0.397,8,15,0.533,2,15,17,14,3,3,8,15,39
277,Kenneth Lofton Jr.\loftoke01,PF,21,MEM,15,0,99,14,37,0.378,3,10,0.3,11,27,0.407,0.419,8,15,0.533,2,13,15,14,3,3,6,15,39
277,Kenneth Lofton Jr.\loftoke01,PF,21,PHI,1,0,4,0,2,0.0,0,0,,0,2,0.0,0.0,0,0,,0,2,2,0,0,0,2,0,0
278,Kevon Looney\looneke01,C,27,GSW,40,34,818,94,152,0.618,0,0,,94,152,0.618,0.618,38,54,0.704,105,179,284,96,21,12,29,100,226
279,Brook Lopez\lopezbr01,C,35,MIL,42,42,1321,205,421,0.487,69,209,0.33,136,212,0.642,0.569,62,77,0.805,60,163,223,67,26,121,36,112,541
280,Robin Lopez\lopezro01,C,35,MIL,11,0,32,3,7,0.429,2,5,0.4,1,2,0.5,0.571,2,2,1.0,1,2,3,3,0,1,1,3,10
281,Kevin Love\loveke01,PF,35,MIA,33,5,618,102,230,0.443,54,157,0.344,48,73,0.658,0.561,65,84,0.774,39,180,219,81,13,5,27,63,323
282,Kyle Lowry\lowryky01,PG,37,MIA,37,35,1037,103,242,0.426,62,161,0.385,41,81,0.506,0.554,35,42,0.833,25,104,129,147,39,15,53,94,303
283,Seth Lundy\lundyse01,SF,23,ATL,8,0,49,4,16,0.25,3,13,0.231,1,3,0.333,0.344,3,4,0.75,1,4,5,0,0,0,1,6,14
284,Trey Lyles\lylestr01,PF,28,SAC,27,0,552,63,142,0.444,41,106,0.387,22,36,0.611,0.588,20,32,0.625,25,105,130,36,4,8,16,44,187
285,Théo Maledon\maledth01,PG,22,CHO,13,1,200,19,66,0.288,5,30,0.167,14,36,0.389,0.326,11,12,0.917,4,19,23,28,7,0,15,18,54
286,Sandro Mamukelashvili\mamuksa01,C,24,SAS,24,0,171,22,56,0.393,8,31,0.258,14,25,0.56,0.464,12,16,0.75,16,33,49,25,4,8,8,19,64
287,Terance Mann\mannte01,SG,27,LAC,35,31,879,97,221,0.439,32,108,0.296,65,113,0.575,0.511,29,38,0.763,41,72,113,64,22,11,22,64,255
288,Tre Mann\manntr01,PG,22,OKC,13,0,119,20,40,0.5,8,19,0.421,12,21,0.571,0.6,1,1,1.0,4,20,24,20,3,0,9,3,49
289,Boban Marjanović\marjabo01,C,35,HOU,6,0,37,7,18,0.389,0,2,0.0,7,16,0.438,0.389,0,2,0.0,5,10,15,4,0,1,0,4,14
290,Lauri Markkanen\markkla01,PF,26,UTA,34,34,1111,271,546,0.496,107,272,0.393,164,274,0.599,0.594,167,191,0.874,82,219,301,63,30,21,39,63,816
291,Naji Marshall\marshna01,SF,26,NOP,34,1,630,92,202,0.455,31,81,0.383,61,121,0.504,0.532,52,63,0.825,36,87,123,66,22,6,36,50,267
292,Caleb Martin\martica02,SF,28,MIA,26,12,696,105,232,0.453,30,78,0.385,75,154,0.487,0.517,33,45,0.733,31,95,126,60,19,7,33,53,273
293,Cody Martin\martico01,SF,28,CHO,11,5,286,29,81,0.358,11,35,0.314,18,46,0.391,0.426,6,12,0.5,12,23,35,27,17,11,13,19,75
294,KJ Martin\martike04,SF,23,TOT,27,0,178,21,44,0.477,1,8,0.125,20,36,0.556,0.489,5,10,0.5,6,14,20,12,10,1,6,26,48
294,KJ Martin\martike04,SF,23,LAC,2,0,31,4,10,0.4,1,5,0.2,3,5,0.6,0.45,1,2,0.5,1,2,3,1,2,1,2,3,10
294,KJ Martin\martike04,SF,23,PHI,25,0,147,17,34,0.5,0,3,0.0,17,31,0.548,0.5,4,8,0.5,5,12,17,11,8,0,4,23,38
295,Garrison Mathews\mathega01,SG,27,ATL,28,3,346,33,69,0.478,31,65,0.477,2,4,0.5,0.703,1,5,0.2,7,29,36,15,8,3,12,40,98
296,Bennedict Mathurin\mathube01,SF,21,IND,43,14,1095,216,473,0.457,55,153,0.359,161,320,0.503,0.515,126,152,0.829,45,114,159,83,24,9,68,84,613
297,Wesley Matthews\matthwe02,SG,37,ATL,19,1,213,10,39,0.256,6,30,0.2,4,9,0.444,0.333,14,19,0.737,4,22,26,12,9,4,6,26,40
298,Tyrese Maxey\maxeyty01,PG,23,PHI,40,40,1503,356,794,0.448,126,333,0.378,230,461,0.499,0.528,200,233,0.858,23,123,146,266,43,22,63,85,1038
299,Skylar Mays\mayssk01,PG-SG,26,TOT,24,5,382,59,148,0.399,16,51,0.314,43,97,0.443,0.453,13,17,0.765,10,29,39,79,16,3,18,23,147
299,Skylar Mays\mayssk01,PG,26,POR,21,5,356,53,138,0.384,14,49,0.286,39,89,0.438,0.435,13,17,0.765,9,28,37,75,14,3,18,20,133
299,Skylar Mays\mayssk01,SG,26,LAL,3,0,26,6,10,0.6,2,2,1.0,4,8,0.5,0.7,0,0,,1,1,2,4,2,0,0,3,14
300,Miles McBride\mcbrimi01,PG,23,NYK,30,2,282,47,105,0.448,28,65,0.431,19,40,0.475,0.581,8,10,0.8,4,17,21,27,12,2,10,30,130
301,CJ McCollum\mccolcj01,PG,32,NOP,29,29,929,202,433,0.467,99,228,0.434,103,205,0.502,0.581,60,76,0.789,18,107,125,147,35,24,43,60,563
302,T.J. McConnell\mccontj01,PG,31,IND,35,3,583,122,233,0.524,1,16,0.063,121,217,0.558,0.526,31,42,0.738,18,73,91,188,37,4,50,33,276
303,Jaden McDaniels\mcdanja02,SF,23,MIN,32,31,905,146,279,0.523,40,103,0.388,106,176,0.602,0.595,21,28,0.75,20,59,79,39,27,18,40,100,353
304,Jalen McDaniels\mcdanja01,SF,26,TOR,27,0,245,30,89,0.337,8,44,0.182,22,45,0.489,0.382,14,20,0.7,7,26,33,14,10,3,8,25,82
305,Doug McDermott\mcderdo01,SF,32,SAS,37,0,567,75,167,0.449,61,134,0.455,14,33,0.424,0.632,10,15,0.667,4,32,36,47,10,2,18,39,221
306,JaVale McGee\mcgeeja01,C,36,SAC,32,0,259,60,95,0.632,0,2,0.0,60,93,0.645,0.632,24,38,0.632,32,63,95,14,7,18,31,36,144
307,Bryce McGowens\mcgowbr01,SG,21,CHO,33,10,564,59,134,0.44,25,66,0.379,34,68,0.5,0.534,27,37,0.73,12,47,59,31,9,3,20,49,170
308,Jordan McLaughlin\mclaujo01,PG,27,MIN,21,0,179,19,48,0.396,10,27,0.37,9,21,0.429,0.5,3,6,0.5,6,14,20,36,16,4,6,9,51
309,De'Anthony Melton\meltode01,SG,25,PHI,33,33,959,129,328,0.393,70,193,0.363,59,135,0.437,0.5,62,75,0.827,27,105,132,105,54,15,38,79,390
310,Nathan Mensah\mensana01,C,25,CHO,16,0,231,9,22,0.409,0,0,,9,22,0.409,0.409,9,12,0.75,22,30,52,7,4,10,13,48,27
311,Sam Merrill\merrisa01,SG,27,CLE,25,0,390,68,165,0.412,58,140,0.414,10,25,0.4,0.588,8,9,0.889,12,42,54,42,8,1,8,31,202
312,Chimezie Metu\metuch01,C,26,PHO,32,5,415,63,124,0.508,15,51,0.294,48,73,0.658,0.569,38,43,0.884,22,76,98,17,18,9,24,37,179
313,Vasilije Micić\micicva01,PG,30,OKC,22,0,265,29,70,0.414,9,35,0.257,20,35,0.571,0.479,9,11,0.818,1,15,16,57,8,3,14,22,76
314,Khris Middleton\middlkh01,SF,32,MIL,36,36,920,198,411,0.482,61,162,0.377,137,249,0.55,0.556,61,75,0.813,21,132,153,181,30,11,77,82,518
315,Brandon Miller\millebr02,SF,21,CHO,34,28,1037,183,433,0.423,70,187,0.374,113,246,0.459,0.503,57,70,0.814,31,104,135,75,23,16,56,86,493
316,Jordan Miller\millejo02,SF,24,LAC,4,0,16,3,5,0.6,1,1,1.0,2,4,0.5,0.7,0,0,,2,1,3,0,0,0,1,2,7
317,Leonard Miller\millele01,SF,20,MIN,5,0,19,6,9,0.667,1,3,0.333,5,6,0.833,0.722,0,0,,0,9,9,1,1,1,1,3,13
318,Dariq Whitehead\whiteda01,SF,19,BRK,2,0,24,1,5,0.2,0,3,0.0,1,2,0.5,0.2,1,2,0.5,0,4,4,3,0,1,0,0,3
319,Patty Mills\millspa02,PG,35,ATL,11,0,116,12,26,0.462,10,19,0.526,2,7,0.286,0.654,0,0,,2,9,11,7,4,1,4,16,34
320,Shake Milton\miltosh01,SG,27,MIN,33,0,431,56,139,0.403,13,49,0.265,43,90,0.478,0.45,36,44,0.818,5,39,44,42,14,4,26,40,161
321,Justin Minaya\minayju01,SF,24,POR,11,0,93,6,17,0.353,3,10,0.3,3,7,0.429,0.441,3,6,0.5,5,6,11,4,3,4,2,8,18
322,Josh Minott\minotjo01,SF,21,MIN,15,0,46,8,18,0.444,0,5,0.0,8,13,0.615,0.444,10,12,0.833,1,2,3,3,1,3,1,6,26
323,Davion Mitchell\mitchda01,PG,25,SAC,31,3,374,41,112,0.366,14,57,0.246,27,55,0.491,0.429,11,15,0.733,4,24,28,54,6,2,16,34,107
324,Donovan Mitchell\mitchdo01,SG,27,CLE,31,31,1103,299,648,0.461,96,276,0.348,203,372,0.546,0.535,169,192,0.88,33,136,169,182,59,14,83,65,863
325,Evan Mobley\mobleev01,PF,22,CLE,21,21,705,142,248,0.573,2,10,0.2,140,238,0.588,0.577,50,65,0.769,56,164,220,61,17,35,48,60,336
326,Isaiah Mobley\mobleis01,PF,24,CLE,3,0,14,2,4,0.5,1,2,0.5,1,2,0.5,0.625,0,0,,0,2,2,4,1,0,1,2,5
327,Malik Monk\monkma01,SG,25,SAC,40,0,1042,205,473,0.433,102,260,0.392,103,213,0.484,0.541,92,113,0.814,15,91,106,218,25,28,84,77,604
328,Moses Moody\moodymo01,SG,21,GSW,34,4,611,107,222,0.482,38,106,0.358,69,116,0.595,0.568,45,57,0.789,38,67,105,28,23,10,24,47,297
329,Xavier Moon\moonxa01,SG,29,LAC,2,0,12,1,2,0.5,0,1,0.0,1,1,1.0,0.5,0,0,,0,2,2,3,0,0,1,1,2
330,Taze Moore\mooreta02,SG,25,POR,1,0,4,1,2,0.5,0,1,0.0,1,1,1.0,0.5,0,0,,0,0,0,0,1,0,0,1,2
331,Wendell Moore Jr.\moorewe01,SG,22,MIN,10,0,30,3,5,0.6,0,2,0.0,3,3,1.0,0.6,0,0,,0,3,3,1,3,1,2,3,6
332,Ja Morant\moranja01,PG,24,MEM,9,9,318,80,170,0.471,14,51,0.275,66,119,0.555,0.512,52,64,0.813,6,44,50,73,7,5,27,19,226
333,Marcus Morris\morrima03,PF,34,PHI,33,5,539,74,167,0.443,32,77,0.416,42,90,0.467,0.539,27,32,0.844,18,77,95,23,11,10,13,56,207
334,Markieff Morris\morrima02,PF,34,DAL,16,1,150,15,47,0.319,9,28,0.321,6,19,0.316,0.415,3,4,0.75,4,24,28,11,5,1,9,11,42
335,Trey Murphy III\murphtr02,SF,23,NOP,19,2,486,81,187,0.433,50,130,0.385,31,57,0.544,0.567,38,47,0.809,8,61,69,38,15,7,11,22,250
336,Dejounte Murray\murrade01,SG,27,ATL,42,42,1456,343,729,0.471,97,254,0.382,246,475,0.518,0.537,102,123,0.829,28,176,204,209,57,12,92,72,885
337,Jamal Murray\murraja01,PG,26,DEN,30,30,934,237,495,0.479,70,171,0.409,167,324,0.515,0.549,84,96,0.875,17,98,115,194,25,20,57,63,628
338,Keegan Murray\murrake02,SF,23,SAC,37,37,1214,228,486,0.469,90,242,0.372,138,244,0.566,0.562,52,65,0.8,51,154,205,59,43,20,33,95,598
339,Kris Murray\murrakr01,SF,23,POR,26,0,321,35,88,0.398,15,45,0.333,20,43,0.465,0.483,8,11,0.727,18,30,48,16,20,4,13,18,93
340,Mike Muscala\muscami01,C,32,TOT,26,2,366,37,98,0.378,18,58,0.31,19,40,0.475,0.469,16,22,0.727,23,56,79,25,6,9,17,33,108
340,Mike Muscala\muscami01,C,32,WAS,24,2,338,33,90,0.367,14,51,0.275,19,39,0.487,0.444,15,20,0.75,22,53,75,22,5,7,16,31,95
340,Mike Muscala\muscami01,C,32,DET,2,0,28,4,8,0.5,4,7,0.571,0,1,0.0,0.75,1,2,0.5,1,3,4,3,1,2,1,2,13
341,Svi Mykhailiuk\mykhasv01,SF,26,BOS,19,0,150,15,51,0.294,10,40,0.25,5,11,0.455,0.392,3,6,0.5,5,12,17,6,6,0,6,11,43
342,Larry Nance Jr.\nancela02,C,31,NOP,26,0,457,57,99,0.576,14,30,0.467,43,69,0.623,0.646,21,27,0.778,36,97,133,31,27,10,22,30,149
343,Pete Nance\nancepe01,PF,23,CLE,1,0,3,0,2,0.0,0,0,,0,2,0.0,0.0,0,0,,0,0,0,0,0,0,0,0,0
344,Andrew Nembhard\nembhan01,PG,24,IND,29,11,598,98,206,0.476,19,58,0.328,79,148,0.534,0.522,18,24,0.75,17,32,49,122,26,1,56,60,233
345,Aaron Nesmith\nesmiaa01,SF,24,IND,38,13,968,159,312,0.51,80,172,0.465,79,140,0.564,0.638,43,62,0.694,32,93,125,42,42,26,33,124,441
346,Georges Niang\niangge01,PF,30,CLE,40,1,882,139,318,0.437,74,200,0.37,65,118,0.551,0.553,20,24,0.833,14,137,151,48,11,8,33,95,372
347,Daishen Nix\nixda01,PG,21,MIN,6,0,21,3,8,0.375,2,5,0.4,1,3,0.333,0.5,0,2,0.0,0,1,1,0,1,0,0,0,8
348,Zeke Nnaji\nnajize01,PF,23,DEN,35,0,333,41,86,0.477,5,15,0.333,36,71,0.507,0.506,25,39,0.641,39,36,75,19,9,20,23,55,112
349,Jaylen Nowell\nowelja01,SG,24,MEM,9,1,156,22,55,0.4,4,23,0.174,18,32,0.563,0.436,3,3,1.0,3,11,14,16,3,0,5,13,51
350,Markquis Nowell\nowelma01,SG,24,TOR,1,0,4,0,1,0.0,0,0,,0,1,0.0,0.0,2,2,1.0,2,0,2,2,1,0,0,0,2
351,Frank Ntilikina\ntilila01,PG,25,CHO,1,0,4,0,1,0.0,0,1,0.0,0,0,,0.0,0,0,,0,1,1,1,0,0,1,0,0
352,Jusuf Nurkić\nurkiju01,C,29,PHO,40,40,1111,181,367,0.493,21,77,0.273,160,290,0.552,0.522,97,136,0.713,109,318,427,142,37,42,81,134,480
353,Jordan Nwora\nworajo01,SF,25,TOT,19,0,187,38,83,0.458,12,37,0.324,26,46,0.565,0.53,9,11,0.818,8,25,33,18,6,1,12,19,97
353,Jordan Nwora\nworajo01,SF,25,IND,18,0,183,37,82,0.451,11,36,0.306,26,46,0.565,0.518,9,11,0.818,8,25,33,18,6,1,12,19,94
353,Jordan Nwora\nworajo01,SF,25,TOR,1,0,4,1,1,1.0,1,1,1.0,0,0,,1.5,0,0,,0,0,0,0,0,0,0,0,3
354,Royce O'Neale\onealro01,SF,30,BRK,41,6,1017,101,271,0.373,77,219,0.352,24,52,0.462,0.515,13,20,0.65,32,157,189,124,28,24,43,98,292
355,Chuma Okeke\okekech01,SF,25,ORL,26,8,336,35,87,0.402,21,63,0.333,14,24,0.583,0.523,2,5,0.4,18,52,70,17,7,7,11,15,93
356,Josh Okogie\okogijo01,SG,25,PHO,36,11,666,56,141,0.397,16,66,0.242,40,75,0.533,0.454,58,78,0.744,46,53,99,47,33,17,21,55,186
357,Onyeka Okongwu\okongon01,C,23,ATL,41,3,1011,148,253,0.585,14,47,0.298,134,206,0.65,0.613,72,89,0.809,104,171,275,56,18,41,34,118,382
358,Isaac Okoro\okorois01,SF,23,CLE,31,20,816,99,203,0.488,28,80,0.35,71,123,0.577,0.557,45,66,0.682,42,66,108,65,26,12,28,69,271
359,Kelly Olynyk\olynyke01,C,32,UTA,42,8,873,121,221,0.548,30,73,0.411,91,148,0.615,0.615,62,72,0.861,55,160,215,184,36,12,72,116,334
360,Eugene Omoruyi\omorueu01,SF,26,WAS,19,0,110,32,55,0.582,5,17,0.294,27,38,0.711,0.627,16,21,0.762,11,17,28,11,9,1,9,20,85
361,Cedi Osman\osmande01,SF,28,SAS,42,1,757,115,242,0.475,50,134,0.373,65,108,0.602,0.579,28,42,0.667,17,93,110,78,20,5,25,65,308
362,Kelly Oubre Jr.\oubreke01,SF,28,PHI,29,18,792,139,298,0.466,49,134,0.366,90,164,0.549,0.549,47,64,0.734,27,96,123,29,37,12,27,76,374
363,Chris Paul\paulch01,PG,38,GSW,32,11,882,104,245,0.424,43,119,0.361,61,126,0.484,0.512,35,42,0.833,10,111,121,230,36,3,38,59,286
364,Cameron Payne\payneca01,PG,29,MIL,39,2,596,88,186,0.473,44,111,0.396,44,75,0.587,0.591,34,38,0.895,3,42,45,92,15,2,28,64,254
365,Gary Payton II\paytoga02,SG,31,GSW,16,0,261,36,79,0.456,9,32,0.281,27,47,0.574,0.513,6,9,0.667,16,32,48,13,17,5,10,29,87
366,Drew Peterson\peterdr01,PF,24,BOS,1,0,3,1,1,1.0,1,1,1.0,0,0,,1.5,0,0,,0,0,0,1,0,0,0,1,3
367,Filip Petrušev\petrufi01,C,23,TOT,3,0,10,1,2,0.5,0,0,,1,2,0.5,0.5,1,2,0.5,0,1,1,0,0,0,0,1,3
367,Filip Petrušev\petrufi01,C,23,PHI,1,0,3,0,0,,0,0,,0,0,,,0,0,,0,1,1,0,0,0,0,0,0
367,Filip Petrušev\petrufi01,C,23,SAC,2,0,7,1,2,0.5,0,0,,1,2,0.5,0.5,1,2,0.5,0,0,0,0,0,0,0,1,3
368,Julian Phillips\phillju01,SF,20,CHI,22,0,99,8,24,0.333,1,12,0.083,7,12,0.583,0.354,1,4,0.25,3,8,11,7,1,3,2,12,18
369,Jalen Pickett\pickeja02,SG,24,DEN,15,0,90,11,25,0.44,7,18,0.389,4,7,0.571,0.58,2,2,1.0,1,10,11,10,3,0,6,8,31
370,Scotty Pippen Jr.\pippesc02,PG,23,MEM,1,0,5,1,2,0.5,0,0,,1,2,0.5,0.5,1,1,1.0,1,0,1,1,0,0,1,0,3
371,Mason Plumlee\plumlma01,C,33,LAC,11,2,173,24,34,0.706,0,0,,24,34,0.706,0.706,20,34,0.588,12,41,53,12,5,4,5,15,68
372,Brandin Podziemski\podzibr01,SG,20,GSW,34,10,828,123,269,0.457,45,115,0.391,78,154,0.506,0.541,22,36,0.611,52,135,187,111,31,5,42,65,313
373,Jakob Poeltl\poeltja01,C,28,TOR,36,36,954,170,248,0.685,0,0,,170,248,0.685,0.685,42,79,0.532,99,200,299,89,24,50,57,106,382
374,Aleksej Pokusevski\pokusal01,PF,22,OKC,7,0,43,2,11,0.182,1,8,0.125,1,3,0.333,0.227,1,2,0.5,2,6,8,5,0,1,3,5,6
375,Jordan Poole\poolejo01,SG,24,WAS,41,41,1196,246,595,0.413,80,260,0.308,166,335,0.496,0.481,114,131,0.87,16,77,93,142,41,13,91,126,686
376,Craig Porter Jr.\portecr01,PG,23,CLE,27,5,439,79,157,0.503,7,21,0.333,72,136,0.529,0.525,28,42,0.667,14,60,74,86,17,12,32,28,193
377,Jontay Porter\portejo01,PF,24,TOR,10,4,166,19,53,0.358,8,29,0.276,11,24,0.458,0.434,8,8,1.0,12,23,35,24,8,10,8,20,54
378,Michael Porter Jr.\portemi01,SF,25,DEN,44,44,1380,276,569,0.485,123,304,0.405,153,265,0.577,0.593,46,60,0.767,54,259,313,61,22,34,47,87,721
379,Otto Porter Jr.\porteot01,SF,30,TOR,15,1,174,14,33,0.424,8,23,0.348,6,10,0.6,0.545,3,3,1.0,6,23,29,8,5,5,2,19,39
380,Bobby Portis\portibo01,PF,28,MIL,42,0,977,214,422,0.507,45,120,0.375,169,302,0.56,0.56,51,66,0.773,67,216,283,43,29,19,39,103,524
381,Kristaps Porziņģis\porzikr01,C,28,BOS,32,32,960,207,394,0.525,57,163,0.35,150,231,0.649,0.598,154,184,0.837,53,165,218,64,22,60,52,94,625
382,Micah Potter\pottemi01,PF,25,UTA,2,0,7,0,1,0.0,0,1,0.0,0,0,,0.0,0,0,,0,4,4,0,0,0,0,0,0
383,Dwight Powell\poweldw01,C,32,DAL,39,8,624,61,86,0.709,1,2,0.5,60,84,0.714,0.715,55,73,0.753,72,82,154,66,22,15,19,85,178
384,Norman Powell\powelno01,SG,30,LAC,41,0,1044,190,382,0.497,85,186,0.457,105,196,0.536,0.609,84,96,0.875,6,92,98,39,23,15,36,76,549
385,Joshua Primo\primojo01,SG,21,LAC,1,0,5,1,2,0.5,0,1,0.0,1,1,1.0,0.5,0,0,,0,0,0,0,0,1,3,0,2
386,Taurean Prince\princta02,PF,29,LAL,41,41,1256,143,336,0.426,87,225,0.387,56,111,0.505,0.555,28,38,0.737,11,106,117,74,36,19,37,92,401
387,Payton Pritchard\pritcpa01,PG,26,BOS,43,0,907,121,286,0.423,73,192,0.38,48,94,0.511,0.551,24,31,0.774,43,93,136,127,19,4,25,54,339
388,Olivier-Maxence Prosper\prospol01,PF,21,DAL,23,0,214,22,63,0.349,8,31,0.258,14,32,0.438,0.413,19,27,0.704,15,37,52,19,2,2,4,16,71
389,Trevelin Queen\queentr01,SG,26,ORL,9,0,135,12,30,0.4,3,13,0.231,9,17,0.529,0.45,5,6,0.833,3,14,17,12,6,5,6,14,32
390,Neemias Queta\quetane01,C,24,BOS,16,0,206,30,54,0.556,0,0,,30,54,0.556,0.556,14,18,0.778,32,42,74,7,7,7,6,36,74
391,Immanuel Quickley\quickim01,SG-PG,24,TOT,41,11,1065,216,485,0.445,94,228,0.412,122,257,0.475,0.542,116,134,0.866,9,118,127,137,23,5,44,67,642
391,Immanuel Quickley\quickim01,SG,24,NYK,30,0,720,152,335,0.454,64,162,0.395,88,173,0.509,0.549,82,94,0.872,5,72,77,74,16,3,31,44,450
391,Immanuel Quickley\quickim01,PG,24,TOR,11,11,345,64,150,0.427,30,66,0.455,34,84,0.405,0.527,34,40,0.85,4,46,50,63,7,2,13,23,192
392,Lester Quinones\quinole01,SG,23,GSW,8,0,54,8,21,0.381,5,12,0.417,3,9,0.333,0.5,1,2,0.5,3,6,9,5,1,1,4,6,22
393,Julius Randle\randlju01,PF,29,NYK,43,43,1531,372,788,0.472,70,233,0.3,302,555,0.544,0.516,222,288,0.771,91,307,398,211,24,12,149,118,1036
394,Duop Reath\reathdu01,C,27,POR,30,11,552,106,223,0.475,42,113,0.372,64,110,0.582,0.57,33,42,0.786,45,79,124,36,16,16,24,74,287
395,Austin Reaves\reaveau01,SG,25,LAL,44,19,1323,230,469,0.49,68,195,0.349,162,274,0.591,0.563,131,150,0.873,36,148,184,226,38,5,92,77,659
396,Cam Reddish\reddica01,SF,24,LAL,34,26,799,80,200,0.4,30,91,0.33,50,109,0.459,0.475,35,42,0.833,19,65,84,46,42,8,29,54,225
397,Paul Reed\reedpa01,C,24,PHI,41,8,630,99,180,0.55,6,19,0.316,93,161,0.578,0.567,26,36,0.722,76,114,190,48,26,30,32,89,230
398,Naz Reid\reidna01,C,24,MIN,42,0,949,205,405,0.506,84,203,0.414,121,202,0.599,0.61,50,63,0.794,43,155,198,44,32,29,55,84,544
399,Jared Rhoden\rhodeja01,SG,24,DET,5,0,30,5,9,0.556,1,4,0.25,4,5,0.8,0.611,2,2,1.0,1,3,4,3,0,0,2,4,13
400,Nick Richards\richani01,C,26,CHO,32,19,778,110,163,0.675,0,0,,110,163,0.675,0.675,58,76,0.763,78,165,243,27,12,40,29,87,278
401,Josh Richardson\richajo01,SG,30,MIA,34,4,891,116,271,0.428,50,145,0.345,66,126,0.524,0.52,45,48,0.938,14,77,91,86,19,12,33,60,327
402,Duncan Robinson\robindu01,SF,29,MIA,41,17,1172,195,426,0.458,117,285,0.411,78,141,0.553,0.595,56,64,0.875,11,96,107,123,26,8,57,89,563
403,Jerome Robinson\robinje01,SG,26,GSW,6,0,23,0,7,0.0,0,4,0.0,0,3,0.0,0.0,4,6,0.667,1,2,3,1,0,1,0,1,4
404,Mitchell Robinson\robinmi01,C,25,NYK,21,21,613,58,98,0.592,0,0,,58,98,0.592,0.592,14,38,0.368,112,104,216,15,32,27,21,40,130
405,Orlando Robinson\robinor01,C,23,MIA,18,7,221,31,59,0.525,7,12,0.583,24,47,0.511,0.585,11,16,0.688,18,42,60,27,5,7,13,29,80
406,Jeremiah Robinson-Earl\robinje02,PF,23,NOP,17,1,195,27,51,0.529,8,19,0.421,19,32,0.594,0.608,6,6,1.0,11,34,45,9,6,3,9,14,68
407,David Roddy\roddyda01,PF,22,MEM,39,9,875,119,288,0.413,39,125,0.312,80,163,0.491,0.481,35,49,0.714,35,111,146,53,20,9,37,54,312
408,Ryan Rollins\rolliry01,PG,21,WAS,10,0,66,13,25,0.52,2,3,0.667,11,22,0.5,0.56,13,17,0.765,2,9,11,11,8,3,7,7,41
409,Derrick Rose\rosede01,PG,35,MEM,17,7,304,56,128,0.438,11,33,0.333,45,95,0.474,0.48,19,21,0.905,7,23,30,57,7,2,22,18,142
410,Terry Rozier\roziete01,SG,29,CHO,29,29,1030,247,537,0.46,83,226,0.367,164,311,0.527,0.537,108,127,0.85,17,98,115,194,32,12,61,51,685
411,Rayan Rupert\ruperra01,SG,19,POR,14,0,105,14,40,0.35,6,16,0.375,8,24,0.333,0.425,5,8,0.625,6,13,19,10,2,0,6,6,39
412,D'Angelo Russell\russeda01,PG,27,LAL,40,33,1187,247,513,0.481,94,228,0.412,153,285,0.537,0.573,64,82,0.78,13,94,107,245,32,21,76,79,652
413,Matt Ryan\ryanma01,SF,26,NOP,13,1,298,38,83,0.458,32,68,0.471,6,15,0.4,0.651,13,14,0.929,5,25,30,14,5,1,16,24,121
414,Domantas Sabonis\sabondo01,C,27,SAC,41,41,1445,332,541,0.614,19,46,0.413,313,495,0.632,0.631,143,214,0.668,134,383,517,327,33,23,134,131,826
415,Luka Šamanić\samanlu01,PF,24,UTA,19,0,121,21,55,0.382,5,20,0.25,16,35,0.457,0.427,11,13,0.846,7,31,38,4,1,2,9,13,58
416,Jermaine Samuels\samueje01,SF,25,HOU,6,0,38,5,7,0.714,0,2,0.0,5,5,1.0,0.714,2,2,1.0,1,7,8,2,1,1,0,3,12
417,Adama Sanogo\sanogad01,PF,21,CHI,3,0,11,3,3,1.0,0,0,,3,3,1.0,1.0,2,3,0.667,2,4,6,0,0,0,1,0,8
418,Gui Santos\santogu01,PF,21,GSW,5,0,32,4,10,0.4,1,6,0.167,3,4,0.75,0.45,6,6,1.0,4,7,11,2,0,0,2,3,15
419,Dario Šarić\saricda01,C,29,GSW,40,7,834,145,302,0.48,61,154,0.396,84,148,0.568,0.581,68,80,0.85,57,170,227,96,25,7,51,89,419
420,Olivier Sarr\sarrol01,C,24,OKC,9,0,68,6,11,0.545,2,5,0.4,4,6,0.667,0.636,6,8,0.75,6,20,26,2,0,5,2,14,20
421,Marcus Sasser\sassema01,PG,23,DET,38,0,579,97,209,0.464,39,94,0.415,58,115,0.504,0.557,24,27,0.889,6,53,59,100,21,8,32,50,257
422,Admiral Schofield\schofad01,PF,26,ORL,11,0,44,5,13,0.385,2,8,0.25,3,5,0.6,0.462,0,2,0.0,1,5,6,4,0,0,4,7,12
423,Dennis Schröder\schrode01,PG,30,TOR,43,31,1343,217,479,0.453,68,189,0.36,149,290,0.514,0.524,99,116,0.853,18,96,114,274,35,5,65,90,601
424,Dereon Seabron\seabrde01,SG,23,NOP,5,0,52,4,13,0.308,1,2,0.5,3,11,0.273,0.346,5,6,0.833,1,6,7,4,2,1,0,4,14
425,Alperen Şengün\sengual01,C,21,HOU,42,42,1371,365,678,0.538,24,85,0.282,341,593,0.575,0.556,168,234,0.718,112,273,385,210,51,32,111,137,922
426,Brice Sensabaugh\sensabr01,SF,20,UTA,4,0,12,2,6,0.333,1,2,0.5,1,4,0.25,0.417,0,0,,1,2,3,2,0,0,0,1,5
427,Collin Sexton\sextoco01,SG,25,UTA,44,21,1064,260,535,0.486,65,173,0.376,195,362,0.539,0.547,182,205,0.888,39,76,115,177,32,7,79,94,767
428,Landry Shamet\shamela01,SG,26,WAS,26,0,403,78,165,0.473,36,92,0.391,42,73,0.575,0.582,21,29,0.724,6,26,32,36,16,7,17,48,213
429,Day'Ron Sharpe\sharpda01,C,22,BRK,37,1,592,111,193,0.575,1,7,0.143,110,186,0.591,0.578,54,88,0.614,103,155,258,53,17,32,37,85,277
430,Shaedon Sharpe\sharpsh01,SG,20,POR,32,25,1059,176,434,0.406,60,180,0.333,116,254,0.457,0.475,98,119,0.824,42,118,160,94,28,12,72,88,510
431,Ben Sheppard\sheppbe01,SG,22,IND,21,0,192,21,58,0.362,11,37,0.297,10,21,0.476,0.457,9,12,0.75,6,16,22,17,10,0,1,23,62
432,Pascal Siakam\siakapa01,PF,29,TOT,41,41,1418,340,651,0.522,48,151,0.318,292,500,0.584,0.559,173,231,0.749,56,200,256,200,33,10,87,98,901
432,Pascal Siakam\siakapa01,PF,29,TOR,39,39,1354,325,623,0.522,46,145,0.317,279,478,0.584,0.559,169,223,0.758,54,192,246,190,32,10,83,87,865
432,Pascal Siakam\siakapa01,PF,29,IND,2,2,64,15,28,0.536,2,6,0.333,13,22,0.591,0.571,4,8,0.5,2,8,10,10,1,0,4,11,36
433,Ben Simmons\simmobe01,PG,27,BRK,6,6,191,19,36,0.528,0,0,,19,36,0.528,0.528,1,4,0.25,16,49,65,40,3,5,15,16,39
434,Anfernee Simons\simonan01,SG,24,POR,20,20,657,155,367,0.422,65,169,0.385,90,198,0.455,0.511,80,89,0.899,9,59,68,96,10,2,48,38,455
435,Jericho Sims\simsje01,C,25,NYK,19,5,119,10,15,0.667,0,0,,10,15,0.667,0.667,3,5,0.6,6,20,26,3,2,2,3,14,23
436,Dmytro Skapintsev\skapidm01,C,25,NYK,2,0,2,0,1,0.0,0,0,,0,1,0.0,0.0,0,0,,0,0,0,0,0,0,0,0,0
437,Jalen Slawson\slawsja01,SF,24,SAC,5,0,19,2,3,0.667,0,1,0.0,2,2,1.0,0.667,0,0,,0,4,4,2,0,1,2,3,4
438,Javonte Smart\smartja01,PG,24,PHI,1,0,1,0,0,,0,0,,0,0,,,0,0,,0,0,0,0,0,0,0,0,0
439,Marcus Smart\smartma01,PG,29,MEM,20,20,605,102,237,0.43,42,134,0.313,60,103,0.583,0.519,43,56,0.768,6,47,53,86,41,5,62,53,289
440,Dennis Smith Jr.\smithde03,PG,26,BRK,27,1,531,79,182,0.434,16,55,0.291,63,127,0.496,0.478,26,32,0.813,26,63,89,110,31,6,31,65,200
441,Dru Smith\smithdr01,SG,26,MIA,9,0,131,15,33,0.455,7,17,0.412,8,16,0.5,0.561,2,2,1.0,6,8,14,14,9,3,5,12,39
442,Ish Smith\smithis01,PG,35,CHO,33,2,550,55,121,0.455,2,6,0.333,53,115,0.461,0.463,3,4,0.75,10,45,55,103,10,3,41,31,115
443,Jabari Smith Jr.\smithja05,PF,20,HOU,40,40,1267,201,424,0.474,68,178,0.382,133,246,0.541,0.554,76,94,0.809,78,270,348,58,23,31,49,116,546
444,Jalen Smith\smithja04,C,23,IND,30,12,535,118,187,0.631,34,68,0.5,84,119,0.706,0.722,41,57,0.719,44,121,165,33,7,15,26,68,311
445,Nick Smith Jr.\smithni01,SG,19,CHO,25,0,376,63,152,0.414,33,74,0.446,30,78,0.385,0.523,3,4,0.75,14,28,42,27,3,7,22,28,162
446,Terquavion Smith\smithte01,PG,21,PHI,2,0,2,2,2,1.0,2,2,1.0,0,0,,1.5,0,0,,0,0,0,0,0,0,0,0,6
447,Jeremy Sochan\sochaje01,PF,20,SAS,42,41,1236,185,421,0.439,42,112,0.375,143,309,0.463,0.489,68,86,0.791,67,170,237,167,31,18,81,103,480
448,Jaden Springer\sprinja01,SG,21,PHI,24,0,237,27,77,0.351,5,25,0.2,22,52,0.423,0.383,13,18,0.722,18,15,33,22,13,9,18,34,72
449,Lamar Stevens\stevela01,PF,26,BOS,16,1,103,15,34,0.441,2,7,0.286,13,27,0.481,0.471,6,8,0.75,8,15,23,6,6,5,7,13,38
450,Isaiah Stewart\stewais01,PF,22,DET,31,31,950,125,268,0.466,45,117,0.385,80,151,0.53,0.55,39,53,0.736,57,157,214,55,10,22,51,78,334
451,Julian Strawther\strawju01,SF,21,DEN,33,0,458,71,185,0.384,37,115,0.322,34,70,0.486,0.484,16,23,0.696,4,45,49,36,16,6,15,47,195
452,Max Strus\strusma01,SF,27,CLE,40,40,1327,185,463,0.4,103,307,0.336,82,156,0.526,0.511,43,53,0.811,30,167,197,153,36,22,66,108,516
453,Jalen Suggs\suggsja01,SG,22,ORL,39,39,1043,181,397,0.456,79,203,0.389,102,194,0.526,0.555,68,88,0.773,29,103,132,92,51,26,76,113,509
454,Cole Swider\swideco01,SF,24,MIA,8,0,38,9,19,0.474,5,14,0.357,4,5,0.8,0.605,0,0,,1,1,2,3,1,1,3,1,23
455,Jae'Sean Tate\tateja01,SF,28,HOU,40,9,745,74,155,0.477,18,61,0.295,56,94,0.596,0.535,20,28,0.714,42,97,139,44,28,9,17,98,186
456,Jayson Tatum\tatumja01,PF,25,BOS,40,40,1433,361,773,0.467,121,333,0.363,240,440,0.545,0.545,225,278,0.809,36,297,333,176,39,19,104,82,1068
457,Terry Taylor\taylote01,PF,24,CHI,16,0,108,13,22,0.591,0,5,0.0,13,17,0.765,0.591,1,1,1.0,12,8,20,4,3,2,7,13,27
458,Garrett Temple\templga01,SG,37,TOR,11,0,45,6,13,0.462,2,5,0.4,4,8,0.5,0.538,4,4,1.0,3,5,8,6,2,0,2,3,18
459,Dalen Terry\terryda01,SG,21,CHI,28,1,282,21,57,0.368,7,34,0.206,14,23,0.609,0.43,15,20,0.75,10,38,48,33,6,8,16,34,64
460,Daniel Theis\theisda01,C,31,TOT,31,1,520,81,156,0.519,13,30,0.433,68,126,0.54,0.561,27,37,0.73,50,62,112,26,14,29,21,70,202
460,Daniel Theis\theisda01,C,31,IND,1,0,8,1,4,0.25,0,1,0.0,1,3,0.333,0.25,0,0,,0,0,0,0,0,0,0,1,2
460,Daniel Theis\theisda01,C,31,LAC,30,1,512,80,152,0.526,13,29,0.448,67,123,0.545,0.569,27,37,0.73,50,62,112,26,14,29,21,69,200
461,Cam Thomas\thomaca02,SG,22,BRK,33,20,944,249,570,0.437,64,182,0.352,185,388,0.477,0.493,117,145,0.807,8,75,83,78,18,10,53,62,679
462,Amen Thompson\thompam01,SF,21,HOU,23,1,377,55,121,0.455,4,30,0.133,51,91,0.56,0.471,30,44,0.682,23,72,95,45,22,7,27,43,144
463,Ausar Thompson\thompau01,SF,21,DET,42,24,1002,148,318,0.465,11,71,0.155,137,247,0.555,0.483,51,78,0.654,92,197,289,84,36,40,57,125,358
464,Klay Thompson\thompkl01,SF,33,GSW,39,39,1187,235,554,0.424,130,337,0.386,105,217,0.484,0.542,74,82,0.902,22,115,137,92,19,20,65,72,674
465,Tristan Thompson\thomptr01,PF,32,CLE,35,0,425,59,88,0.67,0,1,0.0,59,87,0.678,0.67,13,40,0.325,58,77,135,39,7,10,22,49,131
466,JT Thor\thorjt01,PF,21,CHO,34,1,501,44,124,0.355,16,54,0.296,28,70,0.4,0.419,3,7,0.429,37,58,95,14,6,15,8,37,107
467,Matisse Thybulle\thybuma01,SF,26,POR,40,14,903,75,182,0.412,53,145,0.366,22,37,0.595,0.558,13,16,0.813,16,61,77,45,64,34,20,49,216
468,Xavier Tillman Sr.\tillmxa01,C,25,MEM,29,12,600,77,187,0.412,11,49,0.224,66,138,0.478,0.441,13,33,0.394,49,89,138,50,35,28,27,47,178
469,Jacob Toppin\toppija01,SF,23,NYK,3,0,4,0,0,,0,0,,0,0,,,0,0,,0,0,0,1,0,1,0,0,0
470,Obi Toppin\toppiob01,PF,25,IND,43,28,1005,190,326,0.583,58,142,0.408,132,184,0.717,0.672,47,61,0.77,44,124,168,68,21,21,31,91,485
471,Juan Toscano-Anderson\toscaju01,SF,30,SAC,11,0,53,3,12,0.25,1,4,0.25,2,8,0.25,0.292,0,0,,4,10,14,4,1,1,2,11,7
472,Karl-Anthony Towns\townska01,PF,28,MIN,41,41,1349,314,615,0.511,83,193,0.43,231,422,0.547,0.578,173,193,0.896,61,302,363,124,31,22,113,140,884
473,Gary Trent Jr.\trentga02,SG,25,TOR,38,8,984,164,385,0.426,88,212,0.415,76,173,0.439,0.54,28,43,0.651,10,73,83,59,30,5,24,45,444
474,Oscar Tshiebwe\tshieos01,PF,24,IND,6,0,34,8,16,0.5,0,0,,8,16,0.5,0.5,5,6,0.833,6,6,12,2,2,0,0,1,21
475,P.J. Tucker\tuckepj01,PF,38,TOT,15,3,239,6,19,0.316,5,16,0.313,1,3,0.333,0.447,3,3,1.0,16,27,43,8,9,3,4,35,20
475,P.J. Tucker\tuckepj01,PF,38,PHI,3,3,66,2,5,0.4,2,5,0.4,0,0,,0.6,0,0,,1,13,14,0,3,2,2,9,6
475,P.J. Tucker\tuckepj01,PF,38,LAC,12,0,173,4,14,0.286,3,11,0.273,1,3,0.333,0.393,3,3,1.0,15,14,29,8,6,1,2,26,14
476,Myles Turner\turnemy01,C,27,IND,42,42,1153,262,496,0.528,59,170,0.347,203,326,0.623,0.588,145,181,0.801,74,225,299,54,22,83,61,132,728
477,Hunter Tyson\tysonhu01,PF,23,DEN,8,0,20,1,4,0.25,0,3,0.0,1,1,1.0,0.25,0,0,,0,5,5,1,0,0,0,5,2
478,Stanley Umude\umudest01,SG,24,DET,15,0,155,20,44,0.455,14,27,0.519,6,17,0.353,0.614,21,23,0.913,3,25,28,8,4,5,10,24,75
479,Jonas Valančiūnas\valanjo01,C,31,NOP,43,43,1141,232,409,0.567,28,76,0.368,204,333,0.613,0.601,105,129,0.814,111,301,412,99,22,50,62,135,597
480,Jarred Vanderbilt\vandeja01,PF,24,LAL,23,5,439,33,72,0.458,5,22,0.227,28,50,0.56,0.493,11,19,0.579,29,75,104,24,20,3,17,35,82
481,Fred VanVleet\vanvlfr01,PG,29,HOU,40,40,1481,228,561,0.406,123,317,0.388,105,244,0.43,0.516,111,128,0.867,16,135,151,341,41,32,64,88,690
482,Devin Vassell\vassede01,SG,23,SAS,37,31,1139,241,527,0.457,92,252,0.365,149,275,0.542,0.545,84,105,0.8,14,114,128,123,46,7,49,38,658
483,Sasha Vezenkov\vezenal01,PF,28,SAC,32,0,412,69,154,0.448,34,93,0.366,35,61,0.574,0.558,7,10,0.7,29,54,83,14,15,7,11,30,179
484,Gabe Vincent\vincega01,PG,27,LAL,5,0,127,12,32,0.375,2,17,0.118,10,15,0.667,0.406,1,2,0.5,2,3,5,15,6,0,2,12,27
485,Nikola Vučević\vucevni01,C,33,CHI,39,37,1311,282,603,0.468,42,157,0.268,240,446,0.538,0.502,51,59,0.864,103,308,411,137,29,29,62,102,657
486,Dean Wade\wadede01,PF,27,CLE,33,26,726,62,149,0.416,49,127,0.386,13,22,0.591,0.581,15,19,0.789,31,119,150,30,31,8,16,69,188
487,Franz Wagner\wagnefr01,SF,22,ORL,35,35,1163,268,574,0.467,49,168,0.292,219,406,0.539,0.51,143,167,0.856,37,164,201,137,39,12,63,81,728
488,Moritz Wagner\wagnemo01,C,26,ORL,41,1,780,176,297,0.593,21,70,0.3,155,227,0.683,0.628,88,111,0.793,65,122,187,54,21,13,50,92,461
489,Ish Wainright\wainris01,SF,29,POR,7,0,46,6,18,0.333,6,16,0.375,0,2,0.0,0.5,2,2,1.0,0,9,9,0,2,1,1,4,20
490,Jabari Walker\walkeja01,SF,21,POR,38,4,777,115,236,0.487,21,70,0.3,94,166,0.566,0.532,71,93,0.763,69,157,226,33,25,15,34,86,322
491,Jarace Walker\walkeja02,PF,20,IND,15,0,165,28,64,0.438,12,30,0.4,16,34,0.471,0.531,6,7,0.857,8,20,28,20,9,5,8,15,74
492,Lonnie Walker IV\walkelo01,SG,25,BRK,24,0,450,110,221,0.498,56,118,0.475,54,103,0.524,0.624,29,38,0.763,4,52,56,34,15,9,29,27,305
493,Cason Wallace\wallaca01,SG,20,OKC,42,7,894,108,213,0.507,46,111,0.414,62,102,0.608,0.615,19,23,0.826,27,66,93,59,28,20,21,71,281
494,Jordan Walsh\walshjo01,SF,19,BOS,1,0,3,0,1,0.0,0,1,0.0,0,0,,0.0,0,0,,0,4,4,0,0,0,0,0,0
495,P.J. Washington\washipj01,PF,25,CHO,34,15,965,161,379,0.425,59,186,0.317,102,193,0.528,0.503,50,66,0.758,44,133,177,73,29,24,50,91,431
496,TyTy Washington Jr.\washity02,PG,22,MIL,2,0,6,1,3,0.333,1,2,0.5,0,1,0.0,0.5,0,0,,0,1,1,0,1,0,2,0,3
497,Yuta Watanabe\watanyu01,SF,29,PHO,25,0,365,31,92,0.337,23,73,0.315,8,19,0.421,0.462,10,15,0.667,11,32,43,10,7,7,15,33,95
498,Lindy Waters III\waterli01,SG,26,OKC,15,0,113,16,38,0.421,15,36,0.417,1,2,0.5,0.618,0,0,,1,11,12,10,0,2,2,11,47
499,Trendon Watford\watfotr01,PF,23,BRK,31,0,379,72,135,0.533,10,28,0.357,62,107,0.579,0.57,24,29,0.828,29,60,89,49,15,7,25,50,178
500,Peyton Watson\watsope01,SF,21,DEN,42,2,729,107,227,0.471,29,85,0.341,78,142,0.549,0.535,40,57,0.702,23,88,111,40,21,36,22,69,283
501,Victor Wembanyama\wembavi01,C,20,SAS,36,36,1026,267,578,0.462,53,179,0.296,214,399,0.536,0.508,131,164,0.799,76,287,363,106,39,115,117,82,718
502,Blake Wesley\weslebl01,SG,20,SAS,21,0,201,28,56,0.5,0,11,0.0,28,45,0.622,0.5,9,18,0.5,5,15,20,39,7,1,8,28,65
503,Russell Westbrook\westbru01,PG,35,LAC,41,10,954,184,396,0.465,27,95,0.284,157,301,0.522,0.499,63,97,0.649,65,176,241,195,45,18,90,79,458
504,Coby White\whiteco01,PG,23,CHI,44,44,1560,292,642,0.455,123,310,0.397,169,332,0.509,0.551,111,136,0.816,21,176,197,216,29,13,93,105,818
505,Derrick White\whitede01,SG,29,BOS,39,39,1254,216,458,0.472,106,258,0.411,110,200,0.55,0.587,94,104,0.904,28,132,160,190,41,45,66,86,632
506,Cam Whitmore\whitmca01,SF,19,HOU,19,1,296,66,137,0.482,24,61,0.393,42,76,0.553,0.569,21,35,0.6,10,50,60,6,14,5,14,25,177
507,Aaron Wiggins\wiggiaa01,SG,25,OKC,39,0,490,74,128,0.578,19,38,0.5,55,90,0.611,0.652,22,29,0.759,23,62,85,34,18,4,19,45,189
508,Andrew Wiggins\wiggian01,SF,28,GSW,36,25,948,165,391,0.422,34,115,0.296,131,276,0.475,0.465,63,92,0.685,64,86,150,53,12,15,51,81,427
509,Lindell Wigginton\wiggili01,PG,25,MIL,3,0,8,2,5,0.4,0,2,0.0,2,3,0.667,0.4,2,2,1.0,0,0,0,0,0,0,1,1,6
510,Brandon Williams\willibr03,PG,24,DAL,5,0,30,6,11,0.545,2,3,0.667,4,8,0.5,0.636,2,5,0.4,2,3,5,6,1,1,2,1,16
511,Grant Williams\willigr01,PF,25,DAL,38,27,1019,107,259,0.413,65,176,0.369,42,83,0.506,0.539,31,44,0.705,38,96,134,66,18,24,38,112,310
512,Jalen Williams\willija06,PF,22,OKC,39,39,1252,283,517,0.547,54,118,0.458,229,399,0.574,0.6,114,138,0.826,23,138,161,175,43,20,73,106,734
513,Jaylin Williams\willija07,C,21,OKC,34,0,392,40,104,0.385,24,69,0.348,16,35,0.457,0.5,14,15,0.933,15,87,102,44,13,9,14,51,118
514,Jeenathan Williams\willije02,SG,24,HOU,7,0,55,10,22,0.455,1,3,0.333,9,19,0.474,0.477,4,5,0.8,5,1,6,3,2,0,1,5,25
515,Kenrich Williams\willike04,PF,29,OKC,31,0,475,55,118,0.466,25,63,0.397,30,55,0.545,0.572,3,10,0.3,22,68,90,47,18,4,13,47,138
516,Mark Williams\willima07,C,22,CHO,19,19,508,98,151,0.649,0,0,,98,151,0.649,0.649,46,64,0.719,76,108,184,22,16,20,17,50,242
517,Patrick Williams\willipa01,PF,22,CHI,41,28,1118,152,338,0.45,56,135,0.415,96,203,0.473,0.533,50,64,0.781,45,111,156,62,39,31,53,80,410
518,Robert Williams\williro04,C,26,POR,6,0,119,17,26,0.654,0,0,,17,26,0.654,0.654,7,9,0.778,11,27,38,5,7,7,7,17,41
519,Vince Williams Jr.\willivi01,SG,23,MEM,32,13,754,69,175,0.394,44,123,0.358,25,52,0.481,0.52,48,58,0.828,40,129,169,68,24,20,36,75,230
520,Ziaire Williams\willizi02,SF,22,MEM,40,9,754,110,281,0.391,45,142,0.317,65,139,0.468,0.472,46,56,0.821,28,106,134,53,24,9,49,67,311
521,Zion Williamson\willizi01,PF,23,NOP,35,35,1064,305,519,0.588,4,10,0.4,301,509,0.591,0.592,156,238,0.655,63,136,199,161,34,14,89,90,770
522,Jalen Wilson\wilsoja03,PF,23,BRK,11,0,104,16,32,0.5,2,8,0.25,14,24,0.583,0.531,15,15,1.0,15,9,24,9,3,1,3,9,49
523,Dylan Windler\windldy01,SF,27,TOT,4,0,12,2,3,0.667,2,3,0.667,0,0,,1.0,0,0,,0,1,1,2,0,0,0,2,6
523,Dylan Windler\windldy01,SF,27,NYK,3,0,7,1,2,0.5,1,2,0.5,0,0,,0.75,0,0,,0,1,1,1,0,0,0,1,3
523,Dylan Windler\windldy01,SF,27,LAL,1,0,5,1,1,1.0,1,1,1.0,0,0,,1.5,0,0,,0,0,0,1,0,0,0,1,3
524,James Wiseman\wisemja01,C,22,DET,29,0,424,77,114,0.675,0,2,0.0,77,112,0.688,0.675,21,34,0.618,41,79,120,18,4,20,25,57,175
525,Christian Wood\woodch01,PF,28,LAL,38,1,713,99,210,0.471,31,95,0.326,68,115,0.591,0.545,51,73,0.699,33,180,213,40,11,30,44,57,280
526,Delon Wright\wrighde01,PG,31,WAS,21,0,358,35,93,0.376,11,30,0.367,24,63,0.381,0.435,22,27,0.815,10,37,47,66,30,6,10,18,103
527,Thaddeus Young\youngth01,PF,35,TOR,15,3,173,23,45,0.511,1,4,0.25,22,41,0.537,0.522,2,5,0.4,12,22,34,28,12,1,7,22,49
528,Trae Young\youngtr01,PG,25,ATL,39,39,1416,324,767,0.422,128,352,0.364,196,415,0.472,0.506,273,318,0.858,20,97,117,421,54,9,168,78,1049
529,Omer Yurtseven\yurtsom01,C,25,UTA,24,6,256,38,76,0.5,3,15,0.2,35,61,0.574,0.52,6,10,0.6,35,68,103,13,4,10,22,33,85
530,Cody Zeller\zelleco01,C,31,NOP,30,0,259,19,49,0.388,1,3,0.333,18,46,0.391,0.398,20,33,0.606,35,47,82,31,5,4,11,36,59
531,Ivica Zubac\zubaciv01,C,26,LAC,38,38,1030,201,307,0.655,0,0,,201,307,0.655,0.655,68,105,0.648,124,246,370,48,8,52,43,110,470
